"Olympic Games","Country","Gold","Silver","Bronze","Total"
"1896 Summer","Greece",10,18,20,48
"1896 Summer","Germany",25,5,2,32
"1896 Summer","USA",11,7,2,20
"1896 Summer","France",5,4,2,11
"1896 Summer","UK",3,3,3,9
"1896 Summer","Hungary",2,1,3,6
"1896 Summer","Denmark",1,2,3,6
"1896 Summer","Austria",2,1,2,5
"1896 Summer","Australia",2,0,1,3
"1896 Summer","Switzerland",1,2,0,3
"1896 Summer","Sweden",0,0,0,0
"1896 Summer","Italy",0,0,0,0
"1900 Summer","France",52,101,82,235
"1900 Summer","UK",59,34,15,108
"1900 Summer","USA",30,16,17,63
"1900 Summer","Germany",14,20,11,45
"1900 Summer","Belgium",6,24,13,43
"1900 Summer","Netherlands",3,8,16,27
"1900 Summer","Switzerland",16,4,1,21
"1900 Summer","Denmark",4,3,2,9
"1900 Summer","Norway",0,6,3,9
"1900 Summer","Australia",3,0,3,6
"1900 Summer","Austria",0,3,3,6
"1900 Summer","Italy",3,2,0,5
"1900 Summer","Hungary",1,2,2,5
"1900 Summer","Sweden",3,0,1,4
"1900 Summer","Czech Republic",0,1,2,3
"1900 Summer","Mexico",0,0,3,3
"1900 Summer","Spain",2,0,0,2
"1900 Summer","Cuba",1,1,0,2
"1900 Summer","Canada",1,0,1,2
"1900 Summer","India",0,2,0,2
"1900 Summer","Luxembourg",1,0,0,1
"1900 Summer","Haiti",1,0,0,1
"1900 Summer","New Zealand",1,0,0,1
"1900 Summer","Colombia",0,1,0,1
"1900 Summer","Argentina",0,0,0,0
"1900 Summer","Greece",0,0,0,0
"1900 Summer","Iran",0,0,0,0
"1900 Summer","Peru",0,0,0,0
"1900 Summer","Brazil",0,0,0,0
"1900 Summer","Russia",0,0,0,0
"1900 Summer","Romania",0,0,0,0
"1904 Summer","USA",128,141,125,394
"1904 Summer","Canada",27,9,12,48
"1904 Summer","Germany",4,5,7,16
"1904 Summer","Cuba",5,0,0,5
"1904 Summer","Austria",2,1,1,4
"1904 Summer","Hungary",2,1,1,4
"1904 Summer","Australia",0,3,1,4
"1904 Summer","Switzerland",1,0,2,3
"1904 Summer","Norway",2,0,0,2
"1904 Summer","UK",1,1,0,2
"1904 Summer","Greece",1,0,1,2
"1904 Summer","France",0,2,0,2
"1904 Summer","South Africa",0,0,0,0
"1904 Summer","Italy",0,0,0,0
"1906 Summer","Greece",24,48,30,102
"1906 Summer","France",20,16,28,64
"1906 Summer","Italy",21,8,27,56
"1906 Summer","UK",9,22,8,39
"1906 Summer","Denmark",14,19,1,34
"1906 Summer","Germany",14,10,6,30
"1906 Summer","Norway",20,5,0,25
"1906 Summer","USA",12,6,6,24
"1906 Summer","Sweden",2,5,14,21
"1906 Summer","Hungary",5,5,3,13
"1906 Summer","Switzerland",8,3,1,12
"1906 Summer","Belgium",2,3,6,11
"1906 Summer","Austria",3,3,3,9
"1906 Summer","Netherlands",0,1,5,6
"1906 Summer","Finland",2,1,1,4
"1906 Summer","Czech Republic",0,0,3,3
"1906 Summer","Australia",0,0,3,3
"1906 Summer","Canada",1,1,0,2
"1906 Summer","Egypt",0,0,0,0
"1906 Summer","Turkey",0,0,0,0
"1908 Summer","UK",147,131,90,368
"1908 Summer","Sweden",48,18,18,84
"1908 Summer","USA",34,16,15,65
"1908 Summer","Canada",14,8,30,52
"1908 Summer","Norway",7,32,3,42
"1908 Summer","France",12,5,23,40
"1908 Summer","Belgium",1,24,8,33
"1908 Summer","Finland",1,1,28,30
"1908 Summer","Germany",4,11,6,21
"1908 Summer","Hungary",7,7,6,20
"1908 Summer","Australia",15,2,2,19
"1908 Summer","Denmark",0,14,3,17
"1908 Summer","Netherlands",0,0,16,16
"1908 Summer","Italy",2,6,0,8
"1908 Summer","Czech Republic",0,0,6,6
"1908 Summer","Greece",0,3,1,4
"1908 Summer","Russia",1,2,0,3
"1908 Summer","South Africa",1,1,0,2
"1908 Summer","Austria",0,0,1,1
"1908 Summer","Switzerland",0,0,0,0
"1908 Summer","Argentina",0,0,0,0
"1908 Summer","Iceland",0,0,0,0
"1912 Summer","Sweden",103,62,25,190
"1912 Summer","UK",47,64,59,170
"1912 Summer","USA",46,25,36,107
"1912 Summer","Denmark",5,49,33,87
"1912 Summer","Norway",40,6,34,80
"1912 Summer","Finland",9,40,22,71
"1912 Summer","Germany",11,19,23,53
"1912 Summer","Hungary",10,17,3,30
"1912 Summer","France",10,11,5,26
"1912 Summer","Netherlands",0,0,26,26
"1912 Summer","Italy",22,1,2,25
"1912 Summer","Belgium",7,1,11,19
"1912 Summer","Austria",0,9,5,14
"1912 Summer","Russia",0,5,9,14
"1912 Summer","Australia",5,2,3,10
"1912 Summer","Canada",3,2,3,8
"1912 Summer","South Africa",5,2,0,7
"1912 Summer","Switzerland",2,0,0,2
"1912 Summer","Greece",1,0,1,2
"1912 Summer","Chile",0,0,0,0
"1912 Summer","Portugal",0,0,0,0
"1912 Summer","NA",0,0,0,0
"1912 Summer","Poland",0,0,0,0
"1912 Summer","Turkey",0,0,0,0
"1912 Summer","Iceland",0,0,0,0
"1912 Summer","Luxembourg",0,0,0,0
"1912 Summer","Czech Republic",0,0,0,0
"1912 Summer","Japan",0,0,0,0
"1912 Summer","Serbia",0,0,0,0
"1920 Summer","USA",111,45,38,194
"1920 Summer","Belgium",57,65,66,188
"1920 Summer","Sweden",52,38,64,154
"1920 Summer","France",13,71,57,141
"1920 Summer","Norway",58,52,27,137
"1920 Summer","UK",52,42,17,111
"1920 Summer","Italy",67,9,8,84
"1920 Summer","Denmark",26,44,1,71
"1920 Summer","Finland",21,14,17,52
"1920 Summer","Netherlands",15,10,25,50
"1920 Summer","Switzerland",6,2,21,29
"1920 Summer","Spain",0,23,0,23
"1920 Summer","South Africa",3,12,6,21
"1920 Summer","Canada",10,3,3,16
"1920 Summer","Czech Republic",0,0,10,10
"1920 Summer","Brazil",1,1,5,7
"1920 Summer","Australia",0,6,1,7
"1920 Summer","Greece",0,5,0,5
"1920 Summer","Estonia",1,2,0,3
"1920 Summer","Japan",0,3,0,3
"1920 Summer","Luxembourg",0,1,0,1
"1920 Summer","New Zealand",0,0,1,1
"1920 Summer","Egypt",0,0,0,0
"1920 Summer","India",0,0,0,0
"1920 Summer","Serbia",0,0,0,0
"1920 Summer","Monaco",0,0,0,0
"1920 Summer","Chile",0,0,0,0
"1920 Summer","Argentina",0,0,0,0
"1920 Summer","Portugal",0,0,0,0
"1924 Summer","USA",97,36,49,182
"1924 Summer","France",37,51,22,110
"1924 Summer","Sweden",7,22,43,72
"1924 Summer","UK",15,30,19,64
"1924 Summer","Switzerland",14,25,21,60
"1924 Summer","Finland",24,13,15,52
"1924 Summer","Italy",25,5,21,51
"1924 Summer","Belgium",3,30,6,39
"1924 Summer","Netherlands",8,1,18,27
"1924 Summer","Norway",14,5,3,22
"1924 Summer","Hungary",2,12,8,22
"1924 Summer","Canada",0,19,1,20
"1924 Summer","Romania",0,0,16,16
"1924 Summer","Uruguay",14,0,0,14
"1924 Summer","Denmark",2,9,3,14
"1924 Summer","Argentina",5,3,2,10
"1924 Summer","Australia",3,5,2,10
"1924 Summer","Czech Republic",1,4,5,10
"1924 Summer","Estonia",1,1,4,6
"1924 Summer","Poland",0,4,1,5
"1924 Summer","Haiti",0,0,5,5
"1924 Summer","Austria",0,3,1,4
"1924 Summer","Portugal",0,0,4,4
"1924 Summer","South Africa",1,1,1,3
"1924 Summer","Serbia",2,0,0,2
"1924 Summer","Luxembourg",1,1,0,2
"1924 Summer","Ireland",0,1,1,2
"1924 Summer","Greece",1,0,0,1
"1924 Summer","New Zealand",0,0,1,1
"1924 Summer","Japan",0,0,1,1
"1924 Summer","Monaco",0,0,1,1
"1924 Summer","Latvia",0,0,0,0
"1924 Summer","Chile",0,0,0,0
"1924 Summer","Lithuania",0,0,0,0
"1924 Summer","Egypt",0,0,0,0
"1924 Summer","Bulgaria",0,0,0,0
"1924 Summer","Mexico",0,0,0,0
"1924 Summer","Turkey",0,0,0,0
"1924 Summer","Brazil",0,0,0,0
"1924 Summer","Cuba",0,0,0,0
"1924 Summer","Russia",0,0,0,0
"1924 Summer","Spain",0,0,0,0
"1924 Summer","Ecuador",0,0,0,0
"1924 Summer","Philippines",0,0,0,0
"1924 Summer","India",0,0,0,0
"1924 Winter","UK",16,4,11,31
"1924 Winter","Norway",4,7,6,17
"1924 Winter","Finland",4,8,3,15
"1924 Winter","USA",1,10,1,12
"1924 Winter","France",0,0,10,10
"1924 Winter","Canada",9,0,0,9
"1924 Winter","Switzerland",8,0,1,9
"1924 Winter","Sweden",1,8,0,9
"1924 Winter","India",7,0,0,7
"1924 Winter","Belgium",0,0,5,5
"1924 Winter","Austria",3,1,0,4
"1924 Winter","Australia",1,0,0,1
"1924 Winter","Nepal",1,0,0,1
"1924 Winter","Serbia",0,0,0,0
"1924 Winter","Latvia",0,0,0,0
"1924 Winter","Czech Republic",0,0,0,0
"1924 Winter","Italy",0,0,0,0
"1924 Winter","Hungary",0,0,0,0
"1924 Winter","Poland",0,0,0,0
"1928 Summer","USA",47,24,17,88
"1928 Summer","Germany",21,15,41,77
"1928 Summer","Italy",24,22,26,72
"1928 Summer","UK",7,27,24,58
"1928 Summer","Netherlands",20,29,8,57
"1928 Summer","France",12,24,14,50
"1928 Summer","Sweden",7,8,22,37
"1928 Summer","Canada",7,5,21,33
"1928 Summer","Switzerland",16,10,4,30
"1928 Summer","Argentina",3,18,5,26
"1928 Summer","Finland",8,8,9,25
"1928 Summer","Hungary",10,11,0,21
"1928 Summer","Poland",2,3,15,20
"1928 Summer","Uruguay",17,0,0,17
"1928 Summer","Czech Republic",2,12,2,16
"1928 Summer","Denmark",6,5,4,15
"1928 Summer","India",14,0,0,14
"1928 Summer","Serbia",1,1,10,12
"1928 Summer","Norway",4,4,1,9
"1928 Summer","Japan",2,6,1,9
"1928 Summer","Estonia",2,1,6,9
"1928 Summer","South Africa",1,0,5,6
"1928 Summer","Portugal",0,0,6,6
"1928 Summer","Austria",3,0,2,5
"1928 Summer","Belgium",0,1,4,5
"1928 Summer","Egypt",2,1,1,4
"1928 Summer","Australia",1,2,1,4
"1928 Summer","Spain",3,0,0,3
"1928 Summer","New Zealand",1,0,0,1
"1928 Summer","Luxembourg",1,0,0,1
"1928 Summer","Ireland",1,0,0,1
"1928 Summer","Haiti",0,1,0,1
"1928 Summer","Chile",0,1,0,1
"1928 Summer","Philippines",0,0,1,1
"1928 Summer","Panama",0,0,0,0
"1928 Summer","Greece",0,0,0,0
"1928 Summer","Bulgaria",0,0,0,0
"1928 Summer","Cuba",0,0,0,0
"1928 Summer","Monaco",0,0,0,0
"1928 Summer","Romania",0,0,0,0
"1928 Summer","Turkey",0,0,0,0
"1928 Summer","Mexico",0,0,0,0
"1928 Summer","Zimbabwe",0,0,0,0
"1928 Summer","Latvia",0,0,0,0
"1928 Summer","Malta",0,0,0,0
"1928 Summer","Lithuania",0,0,0,0
"1928 Winter","Sweden",2,13,1,16
"1928 Winter","Norway",6,4,5,15
"1928 Winter","USA",6,6,2,14
"1928 Winter","Canada",12,0,0,12
"1928 Winter","Switzerland",0,0,12,12
"1928 Winter","Austria",0,4,2,6
"1928 Winter","Germany",0,0,5,5
"1928 Winter","Finland",2,1,1,4
"1928 Winter","France",2,0,0,2
"1928 Winter","Belgium",0,0,1,1
"1928 Winter","Czech Republic",0,0,1,1
"1928 Winter","UK",0,0,1,1
"1928 Winter","Japan",0,0,0,0
"1928 Winter","Lithuania",0,0,0,0
"1928 Winter","Estonia",0,0,0,0
"1928 Winter","Poland",0,0,0,0
"1928 Winter","Argentina",0,0,0,0
"1928 Winter","Netherlands",0,0,0,0
"1928 Winter","Latvia",0,0,0,0
"1928 Winter","Mexico",0,0,0,0
"1928 Winter","Hungary",0,0,0,0
"1928 Winter","Italy",0,0,0,0
"1928 Winter","Luxembourg",0,0,0,0
"1928 Winter","Serbia",0,0,0,0
"1928 Winter","Romania",0,0,0,0
"1932 Summer","USA",81,47,61,189
"1932 Summer","Italy",21,38,18,77
"1932 Summer","Germany",10,26,7,43
"1932 Summer","France",26,8,6,40
"1932 Summer","Canada",2,13,24,39
"1932 Summer","UK",9,12,14,35
"1932 Summer","Hungary",20,5,8,33
"1932 Summer","Sweden",13,7,12,32
"1932 Summer","Japan",10,17,4,31
"1932 Summer","Finland",5,8,16,29
"1932 Summer","Poland",3,4,14,21
"1932 Summer","India",15,0,0,15
"1932 Summer","Netherlands",2,10,1,13
"1932 Summer","Denmark",0,7,4,11
"1932 Summer","Czech Republic",1,3,2,6
"1932 Summer","Australia",3,1,1,5
"1932 Summer","South Africa",2,0,3,5
"1932 Summer","Austria",1,1,3,5
"1932 Summer","Argentina",3,1,0,4
"1932 Summer","Philippines",0,0,3,3
"1932 Summer","Ireland",2,0,0,2
"1932 Summer","New Zealand",0,2,0,2
"1932 Summer","Mexico",0,2,0,2
"1932 Summer","Latvia",0,1,0,1
"1932 Summer","Switzerland",0,1,0,1
"1932 Summer","Belgium",0,0,1,1
"1932 Summer","Spain",0,0,1,1
"1932 Summer","Uruguay",0,0,1,1
"1932 Summer","China",0,0,0,0
"1932 Summer","Romania",0,0,0,0
"1932 Summer","Monaco",0,0,0,0
"1932 Summer","Luxembourg",0,0,0,0
"1932 Summer","Peru",0,0,0,0
"1932 Summer","Venezuela",0,0,0,0
"1932 Summer","Serbia",0,0,0,0
"1932 Summer","Haiti",0,0,0,0
"1932 Summer","Bulgaria",0,0,0,0
"1932 Summer","Colombia",0,0,0,0
"1932 Summer","Estonia",0,0,0,0
"1932 Summer","Turkey",0,0,0,0
"1932 Summer","Cuba",0,0,0,0
"1932 Summer","Portugal",0,0,0,0
"1932 Summer","Greece",0,0,0,0
"1932 Summer","El Salvador",0,0,0,0
"1932 Summer","Norway",0,0,0,0
"1932 Summer","Guatemala",0,0,0,0
"1932 Summer","Brazil",0,0,0,0
"1932 Winter","USA",10,21,3,34
"1932 Winter","Canada",14,1,5,20
"1932 Winter","Germany",0,0,14,14
"1932 Winter","Norway",3,4,3,10
"1932 Winter","Sweden",1,2,0,3
"1932 Winter","Finland",1,1,1,3
"1932 Winter","France",2,0,0,2
"1932 Winter","Austria",1,1,0,2
"1932 Winter","Switzerland",0,2,0,2
"1932 Winter","Hungary",0,0,2,2
"1932 Winter","Romania",0,0,0,0
"1932 Winter","UK",0,0,0,0
"1932 Winter","Poland",0,0,0,0
"1932 Winter","Italy",0,0,0,0
"1932 Winter","Belgium",0,0,0,0
"1932 Winter","Japan",0,0,0,0
"1932 Winter","Czech Republic",0,0,0,0
"1936 Summer","Germany",93,70,61,224
"1936 Summer","USA",51,29,16,96
"1936 Summer","Italy",37,34,5,76
"1936 Summer","Austria",6,42,7,55
"1936 Summer","Switzerland",5,23,24,52
"1936 Summer","France",13,13,18,44
"1936 Summer","Hungary",25,1,15,41
"1936 Summer","Netherlands",9,7,21,37
"1936 Summer","UK",12,16,8,36
"1936 Summer","Sweden",7,11,17,35
"1936 Summer","Norway",1,12,15,28
"1936 Summer","Finland",8,6,13,27
"1936 Summer","Japan",9,4,10,23
"1936 Summer","Canada",1,12,9,22
"1936 Summer","India",19,0,0,19
"1936 Summer","Czech Republic",5,12,1,18
"1936 Summer","Mexico",0,0,16,16
"1936 Summer","Belgium",0,0,14,14
"1936 Summer","Poland",0,6,6,12
"1936 Summer","Argentina",5,2,4,11
"1936 Summer","Estonia",2,2,3,7
"1936 Summer","Denmark",0,3,3,6
"1936 Summer","Egypt",2,1,2,5
"1936 Summer","Portugal",0,0,3,3
"1936 Summer","Turkey",1,0,1,2
"1936 Summer","Latvia",0,1,1,2
"1936 Summer","New Zealand",1,0,0,1
"1936 Summer","Romania",0,1,0,1
"1936 Summer","South Africa",0,1,0,1
"1936 Summer","Serbia",0,1,0,1
"1936 Summer","Australia",0,0,1,1
"1936 Summer","Philippines",0,0,1,1
"1936 Summer","Monaco",0,0,0,0
"1936 Summer","Uruguay",0,0,0,0
"1936 Summer","Luxembourg",0,0,0,0
"1936 Summer","Boliva",0,0,0,0
"1936 Summer","Chile",0,0,0,0
"1936 Summer","Malta",0,0,0,0
"1936 Summer","Liechtenstein",0,0,0,0
"1936 Summer","Bulgaria",0,0,0,0
"1936 Summer","Costa Rica",0,0,0,0
"1936 Summer","Greece",0,0,0,0
"1936 Summer","Bermuda",0,0,0,0
"1936 Summer","China",0,0,0,0
"1936 Summer","Colombia",0,0,0,0
"1936 Summer","Brazil",0,0,0,0
"1936 Summer","Afghanistan",0,0,0,0
"1936 Summer","Iceland",0,0,0,0
"1936 Summer","Peru",0,0,0,0
"1936 Winter","Norway",7,8,3,18
"1936 Winter","UK",12,1,4,17
"1936 Winter","USA",2,0,14,16
"1936 Winter","Canada",0,13,0,13
"1936 Winter","Switzerland",4,6,0,10
"1936 Winter","Sweden",2,2,6,10
"1936 Winter","Finland",4,2,3,9
"1936 Winter","Germany",4,3,0,7
"1936 Winter","Austria",1,2,2,5
"1936 Winter","Hungary",0,0,2,2
"1936 Winter","France",0,0,1,1
"1936 Winter","Japan",0,0,0,0
"1936 Winter","Italy",0,0,0,0
"1936 Winter","Belgium",0,0,0,0
"1936 Winter","Australia",0,0,0,0
"1936 Winter","Estonia",0,0,0,0
"1936 Winter","Poland",0,0,0,0
"1936 Winter","Latvia",0,0,0,0
"1936 Winter","Serbia",0,0,0,0
"1936 Winter","Liechtenstein",0,0,0,0
"1936 Winter","Netherlands",0,0,0,0
"1936 Winter","Romania",0,0,0,0
"1936 Winter","Turkey",0,0,0,0
"1936 Winter","Spain",0,0,0,0
"1936 Winter","Czech Republic",0,0,0,0
"1936 Winter","Luxembourg",0,0,0,0
"1936 Winter","Bulgaria",0,0,0,0
"1936 Winter","Greece",0,0,0,0
"1948 Summer","USA",87,30,35,152
"1948 Summer","Sweden",30,15,30,75
"1948 Summer","France",26,22,24,72
"1948 Summer","Italy",21,32,14,67
"1948 Summer","Hungary",15,25,22,62
"1948 Summer","UK",7,42,12,61
"1948 Summer","Denmark",7,17,27,51
"1948 Summer","Netherlands",8,2,32,42
"1948 Summer","Switzerland",5,25,6,36
"1948 Summer","Finland",17,8,8,33
"1948 Summer","India",20,0,0,20
"1948 Summer","Czech Republic",14,3,3,20
"1948 Summer","Norway",3,4,11,18
"1948 Summer","Australia",2,9,5,16
"1948 Summer","Serbia",0,16,0,16
"1948 Summer","Belgium",5,2,8,15
"1948 Summer","Turkey",6,4,2,12
"1948 Summer","Argentina",3,7,1,11
"1948 Summer","Brazil",0,0,10,10
"1948 Summer","Mexico",4,1,4,9
"1948 Summer","Austria",2,2,4,8
"1948 Summer","Canada",0,2,5,7
"1948 Summer","South Africa",2,2,2,6
"1948 Summer","Egypt",2,2,1,5
"1948 Summer","Portugal",0,2,3,5
"1948 Summer","Jamaica",1,2,0,3
"1948 Summer","Spain",0,3,0,3
"1948 Summer","Uruguay",0,1,2,3
"1948 Summer","Poland",1,0,1,2
"1948 Summer","Cuba",0,2,0,2
"1948 Summer","South Korea",0,0,2,2
"1948 Summer","Panama",0,0,2,2
"1948 Summer","Peru",1,0,0,1
"1948 Summer","Sri Lanka",0,1,0,1
"1948 Summer","Trinidad",0,1,0,1
"1948 Summer","Iran",0,0,1,1
"1948 Summer","Ireland",0,0,1,1
"1948 Summer","Puerto Rico",0,0,1,1
"1948 Summer","Chile",0,0,0,0
"1948 Summer","Guyana",0,0,0,0
"1948 Summer","Venezuela",0,0,0,0
"1948 Summer","Myanmar",0,0,0,0
"1948 Summer","Iraq",0,0,0,0
"1948 Summer","China",0,0,0,0
"1948 Summer","Colombia",0,0,0,0
"1948 Summer","Philippines",0,0,0,0
"1948 Summer","Luxembourg",0,0,0,0
"1948 Summer","Monaco",0,0,0,0
"1948 Summer","New Zealand",0,0,0,0
"1948 Summer","Lebanon",0,0,0,0
"1948 Summer","Malta",0,0,0,0
"1948 Summer","Iceland",0,0,0,0
"1948 Summer","Pakistan",0,0,0,0
"1948 Summer","Liechtenstein",0,0,0,0
"1948 Summer","Syria",0,0,0,0
"1948 Summer","Afghanistan",0,0,0,0
"1948 Summer","Greece",0,0,0,0
"1948 Summer","Bermuda",0,0,0,0
"1948 Winter","Switzerland",4,5,19,28
"1948 Winter","Czech Republic",0,17,0,17
"1948 Winter","USA",6,4,6,16
"1948 Winter","Canada",13,0,2,15
"1948 Winter","Sweden",7,3,3,13
"1948 Winter","Norway",4,3,6,13
"1948 Winter","Finland",1,6,2,9
"1948 Winter","Austria",1,3,4,8
"1948 Winter","Belgium",2,4,0,6
"1948 Winter","France",2,1,2,5
"1948 Winter","Hungary",0,2,0,2
"1948 Winter","UK",0,0,2,2
"1948 Winter","Italy",1,0,0,1
"1948 Winter","Romania",0,0,0,0
"1948 Winter","Lebanon",0,0,0,0
"1948 Winter","Chile",0,0,0,0
"1948 Winter","Netherlands",0,0,0,0
"1948 Winter","Turkey",0,0,0,0
"1948 Winter","Spain",0,0,0,0
"1948 Winter","Denmark",0,0,0,0
"1948 Winter","Iceland",0,0,0,0
"1948 Winter","Bulgaria",0,0,0,0
"1948 Winter","Greece",0,0,0,0
"1948 Winter","Poland",0,0,0,0
"1948 Winter","South Korea",0,0,0,0
"1948 Winter","Argentina",0,0,0,0
"1948 Winter","Liechtenstein",0,0,0,0
"1948 Winter","Serbia",0,0,0,0
"1952 Summer","USA",83,23,28,134
"1952 Summer","Russia",36,62,19,117
"1952 Summer","Hungary",53,17,32,102
"1952 Summer","Sweden",23,24,23,70
"1952 Summer","Italy",17,22,15,54
"1952 Summer","France",14,9,17,40
"1952 Summer","Finland",8,3,29,40
"1952 Summer","Germany",0,14,26,40
"1952 Summer","Switzerland",2,19,12,33
"1952 Summer","UK",3,2,26,31
"1952 Summer","Czech Republic",11,4,10,25
"1952 Summer","Serbia",4,20,0,24
"1952 Summer","Australia",7,2,11,20
"1952 Summer","Netherlands",0,18,0,18
"1952 Summer","India",14,0,1,15
"1952 Summer","South Africa",2,8,4,14
"1952 Summer","Uruguay",0,0,14,14
"1952 Summer","Norway",5,8,0,13
"1952 Summer","Japan",1,9,2,12
"1952 Summer","Denmark",3,1,5,9
"1952 Summer","Jamaica",5,3,0,8
"1952 Summer","Belgium",5,3,0,8
"1952 Summer","Iran",0,3,4,7
"1952 Summer","Argentina",2,2,2,6
"1952 Summer","Canada",1,3,0,4
"1952 Summer","Poland",1,2,1,4
"1952 Summer","Romania",1,1,2,4
"1952 Summer","Chile",0,4,0,4
"1952 Summer","Turkey",2,0,1,3
"1952 Summer","Brazil",1,0,2,3
"1952 Summer","New Zealand",1,0,2,3
"1952 Summer","Austria",0,1,2,3
"1952 Summer","Lebanon",0,1,1,2
"1952 Summer","South Korea",0,0,2,2
"1952 Summer","Trinidad",0,0,2,2
"1952 Summer","Portugal",0,0,2,2
"1952 Summer","Luxembourg",1,0,0,1
"1952 Summer","Spain",0,1,0,1
"1952 Summer","Mexico",0,1,0,1
"1952 Summer","Ireland",0,1,0,1
"1952 Summer","Bulgaria",0,0,1,1
"1952 Summer","Venezuela",0,0,1,1
"1952 Summer","Egypt",0,0,1,1
"1952 Summer","Curacao",0,0,0,0
"1952 Summer","Greece",0,0,0,0
"1952 Summer","Monaco",0,0,0,0
"1952 Summer","Philippines",0,0,0,0
"1952 Summer","Ghana",0,0,0,0
"1952 Summer","Bahamas",0,0,0,0
"1952 Summer","Iceland",0,0,0,0
"1952 Summer","Israel",0,0,0,0
"1952 Summer","Thailand",0,0,0,0
"1952 Summer","Pakistan",0,0,0,0
"1952 Summer","Guatemala",0,0,0,0
"1952 Summer","Cuba",0,0,0,0
"1952 Summer","Bermuda",0,0,0,0
"1952 Summer","Guyana",0,0,0,0
"1952 Summer","Puerto Rico",0,0,0,0
"1952 Summer","Indonesia",0,0,0,0
"1952 Summer","Vietnam",0,0,0,0
"1952 Summer","Sri Lanka",0,0,0,0
"1952 Summer","Nigeria",0,0,0,0
"1952 Summer","Liechtenstein",0,0,0,0
"1952 Summer","Panama",0,0,0,0
"1952 Summer","Myanmar",0,0,0,0
"1952 Summer","China",0,0,0,0
"1952 Winter","USA",4,25,1,30
"1952 Winter","Sweden",0,0,23,23
"1952 Winter","Norway",7,6,6,19
"1952 Winter","Canada",16,0,1,17
"1952 Winter","Germany",8,2,2,12
"1952 Winter","Finland",6,4,2,12
"1952 Winter","Austria",2,4,2,8
"1952 Winter","Switzerland",0,0,6,6
"1952 Winter","Netherlands",0,3,0,3
"1952 Winter","Italy",1,0,1,2
"1952 Winter","Hungary",0,0,2,2
"1952 Winter","UK",1,0,0,1
"1952 Winter","France",0,0,1,1
"1952 Winter","Iceland",0,0,0,0
"1952 Winter","Serbia",0,0,0,0
"1952 Winter","Lebanon",0,0,0,0
"1952 Winter","Denmark",0,0,0,0
"1952 Winter","Chile",0,0,0,0
"1952 Winter","Romania",0,0,0,0
"1952 Winter","Poland",0,0,0,0
"1952 Winter","New Zealand",0,0,0,0
"1952 Winter","Greece",0,0,0,0
"1952 Winter","Japan",0,0,0,0
"1952 Winter","Bulgaria",0,0,0,0
"1952 Winter","Belgium",0,0,0,0
"1952 Winter","Spain",0,0,0,0
"1952 Winter","Australia",0,0,0,0
"1952 Winter","Argentina",0,0,0,0
"1952 Winter","Portugal",0,0,0,0
"1952 Winter","Czech Republic",0,0,0,0
"1956 Summer","Russia",68,46,55,169
"1956 Summer","USA",61,42,20,123
"1956 Summer","Australia",28,13,26,67
"1956 Summer","Hungary",30,20,14,64
"1956 Summer","Germany",9,20,23,52
"1956 Summer","Italy",26,11,10,47
"1956 Summer","UK",8,16,22,46
"1956 Summer","Sweden",14,14,6,34
"1956 Summer","France",7,13,13,33
"1956 Summer","Finland",3,1,22,26
"1956 Summer","Japan",4,15,5,24
"1956 Summer","Serbia",0,23,0,23
"1956 Summer","Romania",6,3,10,19
"1956 Summer","Canada",5,9,5,19
"1956 Summer","Poland",1,9,9,19
"1956 Summer","Bulgaria",1,3,14,18
"1956 Summer","India",17,0,0,17
"1956 Summer","Pakistan",0,14,0,14
"1956 Summer","Uruguay",0,0,12,12
"1956 Summer","Turkey",3,2,2,7
"1956 Summer","Czech Republic",1,5,1,7
"1956 Summer","South Africa",0,0,7,7
"1956 Summer","Denmark",1,4,1,6
"1956 Summer","Iran",2,2,1,5
"1956 Summer","Ireland",1,1,3,5
"1956 Summer","Chile",0,2,2,4
"1956 Summer","Austria",0,0,4,4
"1956 Summer","New Zealand",3,0,0,3
"1956 Summer","Norway",1,0,2,3
"1956 Summer","Switzerland",0,0,3,3
"1956 Summer","Mexico",1,0,1,2
"1956 Summer","Belgium",0,2,0,2
"1956 Summer","South Korea",0,1,1,2
"1956 Summer","Argentina",0,1,1,2
"1956 Summer","Bahamas",0,0,2,2
"1956 Summer","Brazil",1,0,0,1
"1956 Summer","Iceland",0,1,0,1
"1956 Summer","Greece",0,0,1,1
"1956 Summer","Luxembourg",0,0,0,0
"1956 Summer","Fiji",0,0,0,0
"1956 Summer","Indonesia",0,0,0,0
"1956 Summer","Venezuela",0,0,0,0
"1956 Summer","Jamaica",0,0,0,0
"1956 Summer","Trinidad",0,0,0,0
"1956 Summer","Bermuda",0,0,0,0
"1956 Summer","Malaysia",0,0,0,0
"1956 Summer","Netherlands",0,0,0,0
"1956 Summer","Cuba",0,0,0,0
"1956 Summer","Sri Lanka",0,0,0,0
"1956 Summer","China",0,0,0,0
"1956 Summer","Peru",0,0,0,0
"1956 Summer","Israel",0,0,0,0
"1956 Summer","Colombia",0,0,0,0
"1956 Summer","Nigeria",0,0,0,0
"1956 Summer","Myanmar",0,0,0,0
"1956 Summer","Thailand",0,0,0,0
"1956 Summer","Uganda",0,0,0,0
"1956 Summer","Philippines",0,0,0,0
"1956 Summer","Taiwan",0,0,0,0
"1956 Summer","Liberia",0,0,0,0
"1956 Summer","Cambodia",0,0,0,0
"1956 Summer","Portugal",0,0,0,0
"1956 Summer","Puerto Rico",0,0,0,0
"1956 Summer","Guyana",0,0,0,0
"1956 Summer","Egypt",0,0,0,0
"1956 Summer","Ethiopia",0,0,0,0
"1956 Summer","Afghanistan",0,0,0,0
"1956 Summer","Vietnam",0,0,0,0
"1956 Summer","Kenya",0,0,0,0
"1956 Summer","Spain",0,0,0,0
"1956 Winter","Russia",26,5,6,37
"1956 Winter","USA",2,19,5,26
"1956 Winter","Canada",0,2,18,20
"1956 Winter","Sweden",2,4,9,15
"1956 Winter","Finland",5,6,1,12
"1956 Winter","Austria",5,3,4,12
"1956 Winter","Switzerland",6,2,2,10
"1956 Winter","Italy",2,6,0,8
"1956 Winter","Norway",2,1,1,4
"1956 Winter","Germany",1,0,1,2
"1956 Winter","Hungary",0,0,2,2
"1956 Winter","Japan",0,1,0,1
"1956 Winter","Poland",0,0,1,1
"1956 Winter","UK",0,0,0,0
"1956 Winter","Iceland",0,0,0,0
"1956 Winter","Lebanon",0,0,0,0
"1956 Winter","France",0,0,0,0
"1956 Winter","Belgium",0,0,0,0
"1956 Winter","Iran",0,0,0,0
"1956 Winter","South Korea",0,0,0,0
"1956 Winter","Spain",0,0,0,0
"1956 Winter","Australia",0,0,0,0
"1956 Winter","Serbia",0,0,0,0
"1956 Winter","Bulgaria",0,0,0,0
"1956 Winter","Chile",0,0,0,0
"1956 Winter","Liechtenstein",0,0,0,0
"1956 Winter","Boliva",0,0,0,0
"1956 Winter","Netherlands",0,0,0,0
"1956 Winter","Greece",0,0,0,0
"1956 Winter","Turkey",0,0,0,0
"1956 Winter","Czech Republic",0,0,0,0
"1956 Winter","Romania",0,0,0,0
"1960 Summer","Russia",61,63,45,169
"1960 Summer","USA",81,23,21,125
"1960 Summer","Germany",34,33,22,89
"1960 Summer","Italy",36,18,34,88
"1960 Summer","Hungary",13,16,37,66
"1960 Summer","Australia",11,24,11,46
"1960 Summer","Japan",9,10,12,31
"1960 Summer","Poland",4,11,15,30
"1960 Summer","UK",2,11,15,28
"1960 Summer","Denmark",2,17,4,23
"1960 Summer","Czech Republic",4,7,11,22
"1960 Summer","Serbia",16,1,0,17
"1960 Summer","Romania",3,1,11,15
"1960 Summer","Pakistan",13,0,1,14
"1960 Summer","Spain",0,0,14,14
"1960 Summer","India",0,13,0,13
"1960 Summer","Brazil",0,0,13,13
"1960 Summer","Switzerland",0,6,6,12
"1960 Summer","France",0,6,6,12
"1960 Summer","Turkey",7,2,0,9
"1960 Summer","Canada",0,9,0,9
"1960 Summer","Sweden",2,2,3,7
"1960 Summer","Bulgaria",1,3,3,7
"1960 Summer","Finland",1,1,4,6
"1960 Summer","Trinidad",0,0,5,5
"1960 Summer","Argentina",0,3,1,4
"1960 Summer","Belgium",0,2,2,4
"1960 Summer","Iran",0,1,3,4
"1960 Summer","Greece",3,0,0,3
"1960 Summer","New Zealand",2,0,1,3
"1960 Summer","Austria",1,2,0,3
"1960 Summer","Netherlands",0,1,2,3
"1960 Summer","South Africa",0,1,2,3
"1960 Summer","Norway",2,0,0,2
"1960 Summer","Portugal",0,2,0,2
"1960 Summer","Syria",0,1,1,2
"1960 Summer","Ethiopia",1,0,0,1
"1960 Summer","Ghana",0,1,0,1
"1960 Summer","Taiwan",0,1,0,1
"1960 Summer","Morocco",0,1,0,1
"1960 Summer","Mexico",0,0,1,1
"1960 Summer","Iraq",0,0,1,1
"1960 Summer","Venezuela",0,0,1,1
"1960 Summer","Afghanistan",0,0,0,0
"1960 Summer","Liechtenstein",0,0,0,0
"1960 Summer","Peru",0,0,0,0
"1960 Summer","Guyana",0,0,0,0
"1960 Summer","Colombia",0,0,0,0
"1960 Summer","South Korea",0,0,0,0
"1960 Summer","Iceland",0,0,0,0
"1960 Summer","Chile",0,0,0,0
"1960 Summer","Curacao",0,0,0,0
"1960 Summer","Tunisia",0,0,0,0
"1960 Summer","Fiji",0,0,0,0
"1960 Summer","Israel",0,0,0,0
"1960 Summer","Vietnam",0,0,0,0
"1960 Summer","Zimbabwe",0,0,0,0
"1960 Summer","Sri Lanka",0,0,0,0
"1960 Summer","Bermuda",0,0,0,0
"1960 Summer","Thailand",0,0,0,0
"1960 Summer","Lebanon",0,0,0,0
"1960 Summer","Philippines",0,0,0,0
"1960 Summer","China",0,0,0,0
"1960 Summer","Monaco",0,0,0,0
"1960 Summer","Puerto Rico",0,0,0,0
"1960 Summer","Luxembourg",0,0,0,0
"1960 Summer","Uganda",0,0,0,0
"1960 Summer","Malta",0,0,0,0
"1960 Summer","Kenya",0,0,0,0
"1960 Summer","Myanmar",0,0,0,0
"1960 Summer","Panama",0,0,0,0
"1960 Summer","Haiti",0,0,0,0
"1960 Summer","San Marino",0,0,0,0
"1960 Summer","Ireland",0,0,0,0
"1960 Summer","Liberia",0,0,0,0
"1960 Summer","Nigeria",0,0,0,0
"1960 Summer","Bahamas",0,0,0,0
"1960 Summer","Uruguay",0,0,0,0
"1960 Summer","Sudan",0,0,0,0
"1960 Summer","Cuba",0,0,0,0
"1960 Summer","Malaysia",0,0,0,0
"1960 Summer","Indonesia",0,0,0,0
"1960 Winter","Russia",7,7,28,42
"1960 Winter","USA",19,4,4,27
"1960 Winter","Canada",3,17,1,21
"1960 Winter","Finland",5,3,5,13
"1960 Winter","Sweden",5,2,2,9
"1960 Winter","Germany",4,4,1,9
"1960 Winter","Norway",3,6,0,9
"1960 Winter","Austria",1,2,3,6
"1960 Winter","France",1,0,2,3
"1960 Winter","Switzerland",2,0,0,2
"1960 Winter","Netherlands",0,1,1,2
"1960 Winter","Poland",0,1,1,2
"1960 Winter","Czech Republic",0,1,0,1
"1960 Winter","Italy",0,0,1,1
"1960 Winter","Spain",0,0,0,0
"1960 Winter","Argentina",0,0,0,0
"1960 Winter","Denmark",0,0,0,0
"1960 Winter","Turkey",0,0,0,0
"1960 Winter","South Africa",0,0,0,0
"1960 Winter","Hungary",0,0,0,0
"1960 Winter","Chile",0,0,0,0
"1960 Winter","Bulgaria",0,0,0,0
"1960 Winter","Iceland",0,0,0,0
"1960 Winter","Lebanon",0,0,0,0
"1960 Winter","New Zealand",0,0,0,0
"1960 Winter","Japan",0,0,0,0
"1960 Winter","UK",0,0,0,0
"1960 Winter","Australia",0,0,0,0
"1960 Winter","Liechtenstein",0,0,0,0
"1960 Winter","South Korea",0,0,0,0
"1964 Summer","Russia",60,63,51,174
"1964 Summer","USA",95,37,37,169
"1964 Summer","Germany",22,44,50,116
"1964 Summer","Japan",32,5,25,62
"1964 Summer","Hungary",42,7,7,56
"1964 Summer","Czech Republic",5,37,12,54
"1964 Summer","Italy",14,28,9,51
"1964 Summer","Poland",10,13,23,46
"1964 Summer","Australia",8,6,30,44
"1964 Summer","Netherlands",5,10,16,31
"1964 Summer","France",1,13,17,31
"1964 Summer","UK",4,19,5,28
"1964 Summer","Romania",2,4,10,16
"1964 Summer","Pakistan",0,16,0,16
"1964 Summer","India",15,0,0,15
"1964 Summer","Sweden",3,4,8,15
"1964 Summer","Serbia",2,11,2,15
"1964 Summer","Denmark",7,1,4,12
"1964 Summer","Brazil",0,0,12,12
"1964 Summer","Bulgaria",3,5,2,10
"1964 Summer","New Zealand",4,0,2,6
"1964 Summer","Turkey",2,3,1,6
"1964 Summer","Switzerland",1,4,1,6
"1964 Summer","Trinidad",0,1,5,6
"1964 Summer","Finland",3,0,2,5
"1964 Summer","Canada",2,2,1,5
"1964 Summer","Belgium",2,0,1,3
"1964 Summer","South Korea",0,2,1,3
"1964 Summer","Bahamas",2,0,0,2
"1964 Summer","Tunisia",0,1,1,2
"1964 Summer","Iran",0,0,2,2
"1964 Summer","Ethiopia",1,0,0,1
"1964 Summer","Argentina",0,1,0,1
"1964 Summer","Cuba",0,1,0,1
"1964 Summer","Philippines",0,1,0,1
"1964 Summer","Uruguay",0,0,1,1
"1964 Summer","Ireland",0,0,1,1
"1964 Summer","Kenya",0,0,1,1
"1964 Summer","Nigeria",0,0,1,1
"1964 Summer","Ghana",0,0,1,1
"1964 Summer","Mexico",0,0,1,1
"1964 Summer","Guyana",0,0,0,0
"1964 Summer","Tanzania",0,0,0,0
"1964 Summer","Portugal",0,0,0,0
"1964 Summer","Iceland",0,0,0,0
"1964 Summer","Liechtenstein",0,0,0,0
"1964 Summer","Peru",0,0,0,0
"1964 Summer","Jamaica",0,0,0,0
"1964 Summer","Myanmar",0,0,0,0
"1964 Summer","Senegal",0,0,0,0
"1964 Summer","Curacao",0,0,0,0
"1964 Summer","Spain",0,0,0,0
"1964 Summer","Bermuda",0,0,0,0
"1964 Summer","Taiwan",0,0,0,0
"1964 Summer","Boliva",0,0,0,0
"1964 Summer","Madagascar",0,0,0,0
"1964 Summer","Nepal",0,0,0,0
"1964 Summer","Iraq",0,0,0,0
"1964 Summer","Israel",0,0,0,0
"1964 Summer","Mali",0,0,0,0
"1964 Summer","Dominican Republic",0,0,0,0
"1964 Summer","Algeria",0,0,0,0
"1964 Summer","Luxembourg",0,0,0,0
"1964 Summer","Vietnam",0,0,0,0
"1964 Summer","Morocco",0,0,0,0
"1964 Summer","Colombia",0,0,0,0
"1964 Summer","Republic of Congo",0,0,0,0
"1964 Summer","Austria",0,0,0,0
"1964 Summer","Liberia",0,0,0,0
"1964 Summer","Venezuela",0,0,0,0
"1964 Summer","Norway",0,0,0,0
"1964 Summer","Malaysia",0,0,0,0
"1964 Summer","Afghanistan",0,0,0,0
"1964 Summer","Zimbabwe",0,0,0,0
"1964 Summer","China",0,0,0,0
"1964 Summer","Greece",0,0,0,0
"1964 Summer","Cambodia",0,0,0,0
"1964 Summer","Monaco",0,0,0,0
"1964 Summer","Chile",0,0,0,0
"1964 Summer","Mongolia",0,0,0,0
"1964 Summer","Ivory Coast",0,0,0,0
"1964 Summer","Uganda",0,0,0,0
"1964 Summer","Sri Lanka",0,0,0,0
"1964 Summer","Egypt",0,0,0,0
"1964 Summer","Cameroon",0,0,0,0
"1964 Summer","Zambia",0,0,0,0
"1964 Summer","Lebanon",0,0,0,0
"1964 Summer","Niger",0,0,0,0
"1964 Summer","Costa Rica",0,0,0,0
"1964 Summer","Chad",0,0,0,0
"1964 Summer","Puerto Rico",0,0,0,0
"1964 Summer","Panama",0,0,0,0
"1964 Summer","Thailand",0,0,0,0
"1964 Winter","Russia",30,8,9,47
"1964 Winter","Sweden",6,21,1,28
"1964 Winter","Austria",5,9,3,17
"1964 Winter","Czech Republic",0,0,17,17
"1964 Winter","Finland",3,7,5,15
"1964 Winter","Norway",3,6,6,15
"1964 Winter","Germany",3,4,3,10
"1964 Winter","Italy",0,2,8,10
"1964 Winter","USA",1,2,5,8
"1964 Winter","Canada",4,2,1,7
"1964 Winter","France",3,4,0,7
"1964 Winter","UK",2,0,0,2
"1964 Winter","Netherlands",1,1,0,2
"1964 Winter","North Korea",0,1,0,1
"1964 Winter","Liechtenstein",0,0,0,0
"1964 Winter","Argentina",0,0,0,0
"1964 Winter","Chile",0,0,0,0
"1964 Winter","Hungary",0,0,0,0
"1964 Winter","Spain",0,0,0,0
"1964 Winter","Iran",0,0,0,0
"1964 Winter","Australia",0,0,0,0
"1964 Winter","Romania",0,0,0,0
"1964 Winter","Japan",0,0,0,0
"1964 Winter","Poland",0,0,0,0
"1964 Winter","Greece",0,0,0,0
"1964 Winter","Denmark",0,0,0,0
"1964 Winter","India",0,0,0,0
"1964 Winter","Bulgaria",0,0,0,0
"1964 Winter","Iceland",0,0,0,0
"1964 Winter","Belgium",0,0,0,0
"1964 Winter","Switzerland",0,0,0,0
"1964 Winter","Turkey",0,0,0,0
"1964 Winter","Mongolia",0,0,0,0
"1964 Winter","Serbia",0,0,0,0
"1964 Winter","South Korea",0,0,0,0
"1964 Winter","Lebanon",0,0,0,0
"1968 Summer","Russia",65,63,64,192
"1968 Summer","USA",99,32,35,166
"1968 Summer","Germany",30,36,37,103
"1968 Summer","Hungary",32,20,29,81
"1968 Summer","Japan",16,25,22,63
"1968 Summer","Australia",5,35,11,51
"1968 Summer","Poland",5,2,30,37
"1968 Summer","Italy",5,8,20,33
"1968 Summer","Serbia",13,14,2,29
"1968 Summer","Czech Republic",7,7,15,29
"1968 Summer","France",12,5,10,27
"1968 Summer","Bulgaria",2,21,3,26
"1968 Summer","Romania",5,9,9,23
"1968 Summer","UK",9,5,5,19
"1968 Summer","Denmark",5,6,6,17
"1968 Summer","India",0,0,16,16
"1968 Summer","Netherlands",6,7,1,14
"1968 Summer","Pakistan",13,0,0,13
"1968 Summer","Switzerland",0,3,10,13
"1968 Summer","Kenya",3,7,2,12
"1968 Summer","Canada",3,3,4,10
"1968 Summer","Cuba",0,10,0,10
"1968 Summer","Sweden",4,4,1,9
"1968 Summer","Mexico",3,3,3,9
"1968 Summer","New Zealand",5,0,2,7
"1968 Summer","Norway",4,2,0,6
"1968 Summer","Iran",2,1,2,5
"1968 Summer","Austria",0,2,3,5
"1968 Summer","Finland",1,2,1,4
"1968 Summer","Brazil",0,1,3,4
"1968 Summer","Mongolia",0,1,3,4
"1968 Summer","Belgium",0,1,2,3
"1968 Summer","Turkey",2,0,0,2
"1968 Summer","Ethiopia",1,1,0,2
"1968 Summer","Tunisia",1,0,1,2
"1968 Summer","Uganda",0,1,1,2
"1968 Summer","South Korea",0,1,1,2
"1968 Summer","Argentina",0,0,2,2
"1968 Summer","Venezuela",1,0,0,1
"1968 Summer","Jamaica",0,1,0,1
"1968 Summer","Cameroon",0,1,0,1
"1968 Summer","Greece",0,0,1,1
"1968 Summer","Taiwan",0,0,1,1
"1968 Summer","Egypt",0,0,0,0
"1968 Summer","Vietnam",0,0,0,0
"1968 Summer","Trinidad",0,0,0,0
"1968 Summer","Nigeria",0,0,0,0
"1968 Summer","Barbados",0,0,0,0
"1968 Summer","Boliva",0,0,0,0
"1968 Summer","Afghanistan",0,0,0,0
"1968 Summer","Liechtenstein",0,0,0,0
"1968 Summer","Curacao",0,0,0,0
"1968 Summer","Sierra Leone",0,0,0,0
"1968 Summer","Peru",0,0,0,0
"1968 Summer","Panama",0,0,0,0
"1968 Summer","Nicaragua",0,0,0,0
"1968 Summer","Libya",0,0,0,0
"1968 Summer","Morocco",0,0,0,0
"1968 Summer","Chile",0,0,0,0
"1968 Summer","Virgin Islands, US",0,0,0,0
"1968 Summer","Portugal",0,0,0,0
"1968 Summer","Tanzania",0,0,0,0
"1968 Summer","Ecuador",0,0,0,0
"1968 Summer","Guyana",0,0,0,0
"1968 Summer","Belize",0,0,0,0
"1968 Summer","El Salvador",0,0,0,0
"1968 Summer","Spain",0,0,0,0
"1968 Summer","Central African Republic",0,0,0,0
"1968 Summer","Philippines",0,0,0,0
"1968 Summer","Syria",0,0,0,0
"1968 Summer","San Marino",0,0,0,0
"1968 Summer","Sudan",0,0,0,0
"1968 Summer","Mali",0,0,0,0
"1968 Summer","Puerto Rico",0,0,0,0
"1968 Summer","Colombia",0,0,0,0
"1968 Summer","Niger",0,0,0,0
"1968 Summer","Myanmar",0,0,0,0
"1968 Summer","Malta",0,0,0,0
"1968 Summer","Bermuda",0,0,0,0
"1968 Summer","Ireland",0,0,0,0
"1968 Summer","China",0,0,0,0
"1968 Summer","Israel",0,0,0,0
"1968 Summer","Guinea",0,0,0,0
"1968 Summer","Luxembourg",0,0,0,0
"1968 Summer","Uruguay",0,0,0,0
"1968 Summer","Madagascar",0,0,0,0
"1968 Summer","Indonesia",0,0,0,0
"1968 Summer","Ivory Coast",0,0,0,0
"1968 Summer","Monaco",0,0,0,0
"1968 Summer","Zambia",0,0,0,0
"1968 Summer","Democratic Republic of the Congo",0,0,0,0
"1968 Summer","Suriname",0,0,0,0
"1968 Summer","Malaysia",0,0,0,0
"1968 Summer","Ghana",0,0,0,0
"1968 Summer","Thailand",0,0,0,0
"1968 Summer","Honduras",0,0,0,0
"1968 Summer","Senegal",0,0,0,0
"1968 Summer","Chad",0,0,0,0
"1968 Summer","Bahamas",0,0,0,0
"1968 Summer","Sri Lanka",0,0,0,0
"1968 Summer","Iraq",0,0,0,0
"1968 Summer","Guatemala",0,0,0,0
"1968 Summer","Dominican Republic",0,0,0,0
"1968 Summer","Lebanon",0,0,0,0
"1968 Summer","Iceland",0,0,0,0
"1968 Summer","Costa Rica",0,0,0,0
"1968 Summer","Paraguay",0,0,0,0
"1968 Summer","Kuwait",0,0,0,0
"1968 Summer","Algeria",0,0,0,0
"1968 Summer","Fiji",0,0,0,0
"1968 Winter","Russia",26,6,5,37
"1968 Winter","Norway",11,9,2,22
"1968 Winter","Czech Republic",1,19,1,21
"1968 Winter","Canada",1,1,18,20
"1968 Winter","Germany",4,5,7,16
"1968 Winter","Sweden",3,7,6,16
"1968 Winter","Austria",3,8,4,15
"1968 Winter","France",4,3,2,9
"1968 Winter","Netherlands",3,3,3,9
"1968 Winter","Switzerland",0,2,7,9
"1968 Winter","Italy",8,0,0,8
"1968 Winter","Finland",1,2,5,8
"1968 Winter","USA",1,5,1,7
"1968 Winter","Romania",0,0,2,2
"1968 Winter","Turkey",0,0,0,0
"1968 Winter","Serbia",0,0,0,0
"1968 Winter","Hungary",0,0,0,0
"1968 Winter","Denmark",0,0,0,0
"1968 Winter","Iceland",0,0,0,0
"1968 Winter","Australia",0,0,0,0
"1968 Winter","UK",0,0,0,0
"1968 Winter","Poland",0,0,0,0
"1968 Winter","Argentina",0,0,0,0
"1968 Winter","Iran",0,0,0,0
"1968 Winter","Liechtenstein",0,0,0,0
"1968 Winter","Japan",0,0,0,0
"1968 Winter","Greece",0,0,0,0
"1968 Winter","India",0,0,0,0
"1968 Winter","Mongolia",0,0,0,0
"1968 Winter","Chile",0,0,0,0
"1968 Winter","South Korea",0,0,0,0
"1968 Winter","New Zealand",0,0,0,0
"1968 Winter","Lebanon",0,0,0,0
"1968 Winter","Morocco",0,0,0,0
"1968 Winter","Bulgaria",0,0,0,0
"1968 Winter","Spain",0,0,0,0
"1972 Summer","Germany",74,83,96,253
"1972 Summer","Russia",107,47,60,214
"1972 Summer","USA",69,59,43,171
"1972 Summer","Hungary",10,46,25,81
"1972 Summer","Japan",29,19,8,56
"1972 Summer","Poland",27,8,11,46
"1972 Summer","Romania",3,10,27,40
"1972 Summer","UK",8,9,12,29
"1972 Summer","Czech Republic",2,21,6,29
"1972 Summer","Italy",9,3,13,25
"1972 Summer","Bulgaria",6,10,6,22
"1972 Summer","Sweden",4,10,8,22
"1972 Summer","Cuba",3,1,18,22
"1972 Summer","France",2,5,15,22
"1972 Summer","Australia",11,7,2,20
"1972 Summer","Serbia",15,1,2,18
"1972 Summer","North Korea",1,1,13,15
"1972 Summer","Pakistan",0,15,0,15
"1972 Summer","New Zealand",9,4,1,14
"1972 Summer","India",0,0,14,14
"1972 Summer","Kenya",5,3,4,12
"1972 Summer","Canada",0,2,9,11
"1972 Summer","Finland",3,1,6,10
"1972 Summer","Norway",2,2,4,8
"1972 Summer","Switzerland",0,8,0,8
"1972 Summer","Netherlands",3,1,2,6
"1972 Summer","Iran",0,2,1,3
"1972 Summer","Colombia",0,1,2,3
"1972 Summer","Austria",0,1,2,3
"1972 Summer","Uganda",1,1,0,2
"1972 Summer","Greece",0,2,0,2
"1972 Summer","Belgium",0,2,0,2
"1972 Summer","Ethiopia",0,0,2,2
"1972 Summer","Brazil",0,0,2,2
"1972 Summer","Denmark",1,0,0,1
"1972 Summer","Lebanon",0,1,0,1
"1972 Summer","Mongolia",0,1,0,1
"1972 Summer","South Korea",0,1,0,1
"1972 Summer","Argentina",0,1,0,1
"1972 Summer","Tunisia",0,1,0,1
"1972 Summer","Mexico",0,1,0,1
"1972 Summer","Turkey",0,1,0,1
"1972 Summer","Spain",0,0,1,1
"1972 Summer","Ghana",0,0,1,1
"1972 Summer","Jamaica",0,0,1,1
"1972 Summer","Niger",0,0,1,1
"1972 Summer","Nigeria",0,0,1,1
"1972 Summer","El Salvador",0,0,0,0
"1972 Summer","Bahamas",0,0,0,0
"1972 Summer","Zambia",0,0,0,0
"1972 Summer","Paraguay",0,0,0,0
"1972 Summer","Monaco",0,0,0,0
"1972 Summer","Liberia",0,0,0,0
"1972 Summer","Kuwait",0,0,0,0
"1972 Summer","Ivory Coast",0,0,0,0
"1972 Summer","Swaziland",0,0,0,0
"1972 Summer","Somalia",0,0,0,0
"1972 Summer","Panama",0,0,0,0
"1972 Summer","Luxembourg",0,0,0,0
"1972 Summer","Boliva",0,0,0,0
"1972 Summer","Suriname",0,0,0,0
"1972 Summer","Guatemala",0,0,0,0
"1972 Summer","Ireland",0,0,0,0
"1972 Summer","Haiti",0,0,0,0
"1972 Summer","Vietnam",0,0,0,0
"1972 Summer","Nicaragua",0,0,0,0
"1972 Summer","Tanzania",0,0,0,0
"1972 Summer","Thailand",0,0,0,0
"1972 Summer","San Marino",0,0,0,0
"1972 Summer","Nepal",0,0,0,0
"1972 Summer","Albania",0,0,0,0
"1972 Summer","China",0,0,0,0
"1972 Summer","Sri Lanka",0,0,0,0
"1972 Summer","Chile",0,0,0,0
"1972 Summer","Cameroon",0,0,0,0
"1972 Summer","Peru",0,0,0,0
"1972 Summer","Cambodia",0,0,0,0
"1972 Summer","Philippines",0,0,0,0
"1972 Summer","Curacao",0,0,0,0
"1972 Summer","Saudi Arabia",0,0,0,0
"1972 Summer","Bermuda",0,0,0,0
"1972 Summer","Republic of Congo",0,0,0,0
"1972 Summer","Fiji",0,0,0,0
"1972 Summer","Malta",0,0,0,0
"1972 Summer","Togo",0,0,0,0
"1972 Summer","Barbados",0,0,0,0
"1972 Summer","Sudan",0,0,0,0
"1972 Summer","Indonesia",0,0,0,0
"1972 Summer","Dominican Republic",0,0,0,0
"1972 Summer","Burkina Faso",0,0,0,0
"1972 Summer","Egypt",0,0,0,0
"1972 Summer","Mali",0,0,0,0
"1972 Summer","Morocco",0,0,0,0
"1972 Summer","Senegal",0,0,0,0
"1972 Summer","Syria",0,0,0,0
"1972 Summer","Ecuador",0,0,0,0
"1972 Summer","Trinidad",0,0,0,0
"1972 Summer","Costa Rica",0,0,0,0
"1972 Summer","Algeria",0,0,0,0
"1972 Summer","Madagascar",0,0,0,0
"1972 Summer","Liechtenstein",0,0,0,0
"1972 Summer","Portugal",0,0,0,0
"1972 Summer","Uruguay",0,0,0,0
"1972 Summer","Puerto Rico",0,0,0,0
"1972 Summer","Gabon",0,0,0,0
"1972 Summer","Afghanistan",0,0,0,0
"1972 Summer","Taiwan",0,0,0,0
"1972 Summer","Malawi",0,0,0,0
"1972 Summer","Belize",0,0,0,0
"1972 Summer","Iceland",0,0,0,0
"1972 Summer","Guyana",0,0,0,0
"1972 Summer","Chad",0,0,0,0
"1972 Summer","Malaysia",0,0,0,0
"1972 Summer","Myanmar",0,0,0,0
"1972 Summer","Benin",0,0,0,0
"1972 Summer","Virgin Islands, US",0,0,0,0
"1972 Summer","Israel",0,0,0,0
"1972 Summer","Venezuela",0,0,0,0
"1972 Summer","Lesotho",0,0,0,0
"1972 Winter","Russia",36,6,3,45
"1972 Winter","Germany",9,5,16,30
"1972 Winter","USA",3,18,3,24
"1972 Winter","Czech Republic",1,0,19,20
"1972 Winter","Switzerland",7,3,7,17
"1972 Winter","Norway",2,8,7,17
"1972 Winter","Finland",0,9,1,10
"1972 Winter","Netherlands",4,3,2,9
"1972 Winter","Italy",3,5,1,9
"1972 Winter","Austria",1,2,2,5
"1972 Winter","Sweden",1,1,2,4
"1972 Winter","Japan",1,1,1,3
"1972 Winter","France",0,1,2,3
"1972 Winter","Poland",1,0,0,1
"1972 Winter","Spain",1,0,0,1
"1972 Winter","Canada",0,1,0,1
"1972 Winter","Argentina",0,0,0,0
"1972 Winter","Bulgaria",0,0,0,0
"1972 Winter","Australia",0,0,0,0
"1972 Winter","Romania",0,0,0,0
"1972 Winter","Lebanon",0,0,0,0
"1972 Winter","UK",0,0,0,0
"1972 Winter","Philippines",0,0,0,0
"1972 Winter","Greece",0,0,0,0
"1972 Winter","Serbia",0,0,0,0
"1972 Winter","North Korea",0,0,0,0
"1972 Winter","South Korea",0,0,0,0
"1972 Winter","Hungary",0,0,0,0
"1972 Winter","Liechtenstein",0,0,0,0
"1972 Winter","Iran",0,0,0,0
"1972 Winter","Belgium",0,0,0,0
"1972 Winter","Mongolia",0,0,0,0
"1972 Winter","New Zealand",0,0,0,0
"1972 Winter","Taiwan",0,0,0,0
"1976 Summer","Russia",114,95,77,286
"1976 Summer","Germany",123,76,74,273
"1976 Summer","USA",70,58,36,164
"1976 Summer","Poland",18,29,26,73
"1976 Summer","Hungary",14,6,35,55
"1976 Summer","Romania",4,28,23,55
"1976 Summer","Japan",25,6,10,41
"1976 Summer","Bulgaria",8,13,18,39
"1976 Summer","UK",6,15,11,32
"1976 Summer","Italy",2,25,4,31
"1976 Summer","New Zealand",15,1,9,25
"1976 Summer","Cuba",6,4,14,24
"1976 Summer","Australia",0,15,8,23
"1976 Summer","Canada",0,9,14,23
"1976 Summer","France",5,7,8,20
"1976 Summer","Serbia",2,14,3,19
"1976 Summer","South Korea",1,1,15,17
"1976 Summer","Pakistan",0,0,16,16
"1976 Summer","Czech Republic",2,4,9,15
"1976 Summer","Netherlands",0,2,12,14
"1976 Summer","Sweden",9,1,0,10
"1976 Summer","Switzerland",1,3,6,10
"1976 Summer","Belgium",0,3,6,9
"1976 Summer","Denmark",3,0,5,8
"1976 Summer","Finland",4,2,0,6
"1976 Summer","Norway",2,4,0,6
"1976 Summer","Spain",0,6,0,6
"1976 Summer","Brazil",0,0,3,3
"1976 Summer","North Korea",1,1,0,2
"1976 Summer","Jamaica",1,1,0,2
"1976 Summer","Mexico",1,0,1,2
"1976 Summer","Portugal",0,2,0,2
"1976 Summer","Iran",0,1,1,2
"1976 Summer","Trinidad",1,0,0,1
"1976 Summer","Venezuela",0,1,0,1
"1976 Summer","Mongolia",0,1,0,1
"1976 Summer","Bermuda",0,0,1,1
"1976 Summer","Austria",0,0,1,1
"1976 Summer","Puerto Rico",0,0,1,1
"1976 Summer","Thailand",0,0,1,1
"1976 Summer","Nepal",0,0,0,0
"1976 Summer","Ireland",0,0,0,0
"1976 Summer","Haiti",0,0,0,0
"1976 Summer","Antigua",0,0,0,0
"1976 Summer","Guatemala",0,0,0,0
"1976 Summer","Andorra",0,0,0,0
"1976 Summer","Dominican Republic",0,0,0,0
"1976 Summer","Cayman Islands",0,0,0,0
"1976 Summer","Paraguay",0,0,0,0
"1976 Summer","Colombia",0,0,0,0
"1976 Summer","Suriname",0,0,0,0
"1976 Summer","Philippines",0,0,0,0
"1976 Summer","Nicaragua",0,0,0,0
"1976 Summer","Virgin Islands, US",0,0,0,0
"1976 Summer","San Marino",0,0,0,0
"1976 Summer","Indonesia",0,0,0,0
"1976 Summer","Malaysia",0,0,0,0
"1976 Summer","Senegal",0,0,0,0
"1976 Summer","Egypt",0,0,0,0
"1976 Summer","Belize",0,0,0,0
"1976 Summer","Monaco",0,0,0,0
"1976 Summer","Peru",0,0,0,0
"1976 Summer","Cameroon",0,0,0,0
"1976 Summer","Papua New Guinea",0,0,0,0
"1976 Summer","Ivory Coast",0,0,0,0
"1976 Summer","Israel",0,0,0,0
"1976 Summer","China",0,0,0,0
"1976 Summer","Bahamas",0,0,0,0
"1976 Summer","Panama",0,0,0,0
"1976 Summer","Argentina",0,0,0,0
"1976 Summer","India",0,0,0,0
"1976 Summer","Boliva",0,0,0,0
"1976 Summer","Uruguay",0,0,0,0
"1976 Summer","Barbados",0,0,0,0
"1976 Summer","Honduras",0,0,0,0
"1976 Summer","Costa Rica",0,0,0,0
"1976 Summer","Lebanon",0,0,0,0
"1976 Summer","Greece",0,0,0,0
"1976 Summer","Saudi Arabia",0,0,0,0
"1976 Summer","Luxembourg",0,0,0,0
"1976 Summer","Chile",0,0,0,0
"1976 Summer","Liechtenstein",0,0,0,0
"1976 Summer","Tunisia",0,0,0,0
"1976 Summer","Iceland",0,0,0,0
"1976 Summer","Fiji",0,0,0,0
"1976 Summer","Kuwait",0,0,0,0
"1976 Summer","Turkey",0,0,0,0
"1976 Summer","Ecuador",0,0,0,0
"1976 Summer","Morocco",0,0,0,0
"1976 Summer","Curacao",0,0,0,0
"1976 Winter","Germany",14,13,37,64
"1976 Winter","Russia",38,7,11,56
"1976 Winter","Czech Republic",0,19,0,19
"1976 Winter","Finland",5,10,1,16
"1976 Winter","USA",3,3,5,11
"1976 Winter","Norway",3,6,1,10
"1976 Winter","Switzerland",1,6,2,9
"1976 Winter","Austria",2,2,3,7
"1976 Winter","Netherlands",1,2,3,6
"1976 Winter","Italy",1,2,1,4
"1976 Winter","Canada",1,1,1,3
"1976 Winter","Sweden",0,0,2,2
"1976 Winter","Liechtenstein",0,0,2,2
"1976 Winter","UK",1,0,0,1
"1976 Winter","France",0,0,1,1
"1976 Winter","New Zealand",0,0,0,0
"1976 Winter","Greece",0,0,0,0
"1976 Winter","Iceland",0,0,0,0
"1976 Winter","Andorra",0,0,0,0
"1976 Winter","Poland",0,0,0,0
"1976 Winter","Romania",0,0,0,0
"1976 Winter","Turkey",0,0,0,0
"1976 Winter","Lebanon",0,0,0,0
"1976 Winter","Iran",0,0,0,0
"1976 Winter","Argentina",0,0,0,0
"1976 Winter","Chile",0,0,0,0
"1976 Winter","Serbia",0,0,0,0
"1976 Winter","Hungary",0,0,0,0
"1976 Winter","San Marino",0,0,0,0
"1976 Winter","Japan",0,0,0,0
"1976 Winter","Spain",0,0,0,0
"1976 Winter","Australia",0,0,0,0
"1976 Winter","Belgium",0,0,0,0
"1976 Winter","Bulgaria",0,0,0,0
"1976 Winter","Taiwan",0,0,0,0
"1976 Winter","South Korea",0,0,0,0
"1980 Summer","Russia",187,129,126,442
"1980 Summer","Germany",115,88,61,264
"1980 Summer","Bulgaria",8,44,38,90
"1980 Summer","Romania",7,15,46,68
"1980 Summer","Hungary",8,13,40,61
"1980 Summer","Serbia",13,27,17,57
"1980 Summer","Czech Republic",17,18,16,51
"1980 Summer","Poland",3,25,22,50
"1980 Summer","UK",5,18,24,47
"1980 Summer","Italy",8,21,8,37
"1980 Summer","France",18,5,6,29
"1980 Summer","Spain",2,19,3,24
"1980 Summer","Cuba",8,7,5,20
"1980 Summer","Sweden",3,8,9,20
"1980 Summer","India",16,0,0,16
"1980 Summer","Zimbabwe",15,0,0,15
"1980 Summer","Australia",6,2,5,13
"1980 Summer","Mexico",0,1,9,10
"1980 Summer","Brazil",4,0,5,9
"1980 Summer","Finland",3,1,5,9
"1980 Summer","Denmark",4,2,2,8
"1980 Summer","Netherlands",0,1,5,6
"1980 Summer","Austria",1,3,1,5
"1980 Summer","Greece",1,0,4,5
"1980 Summer","North Korea",0,3,2,5
"1980 Summer","Ethiopia",2,0,2,4
"1980 Summer","Mongolia",0,2,2,4
"1980 Summer","Ireland",0,2,1,3
"1980 Summer","Jamaica",0,0,3,3
"1980 Summer","Switzerland",2,0,0,2
"1980 Summer","Tanzania",0,2,0,2
"1980 Summer","Belgium",1,0,0,1
"1980 Summer","Venezuela",0,1,0,1
"1980 Summer","Uganda",0,1,0,1
"1980 Summer","Guyana",0,0,1,1
"1980 Summer","Lebanon",0,0,1,1
"1980 Summer","Guatemala",0,0,0,0
"1980 Summer","San Marino",0,0,0,0
"1980 Summer","Laos",0,0,0,0
"1980 Summer","Andorra",0,0,0,0
"1980 Summer","Myanmar",0,0,0,0
"1980 Summer","Madagascar",0,0,0,0
"1980 Summer","Mali",0,0,0,0
"1980 Summer","New Zealand",0,0,0,0
"1980 Summer","Zambia",0,0,0,0
"1980 Summer","Jordan",0,0,0,0
"1980 Summer","Kuwait",0,0,0,0
"1980 Summer","Cameroon",0,0,0,0
"1980 Summer","Senegal",0,0,0,0
"1980 Summer","Vietnam",0,0,0,0
"1980 Summer","Colombia",0,0,0,0
"1980 Summer","Cyprus",0,0,0,0
"1980 Summer","Dominican Republic",0,0,0,0
"1980 Summer","Republic of Congo",0,0,0,0
"1980 Summer","Libya",0,0,0,0
"1980 Summer","Angola",0,0,0,0
"1980 Summer","Trinidad",0,0,0,0
"1980 Summer","Ecuador",0,0,0,0
"1980 Summer","Puerto Rico",0,0,0,0
"1980 Summer","Benin",0,0,0,0
"1980 Summer","Iceland",0,0,0,0
"1980 Summer","Lesotho",0,0,0,0
"1980 Summer","Portugal",0,0,0,0
"1980 Summer","Malta",0,0,0,0
"1980 Summer","Seychelles",0,0,0,0
"1980 Summer","Algeria",0,0,0,0
"1980 Summer","Iraq",0,0,0,0
"1980 Summer","Peru",0,0,0,0
"1980 Summer","Sierra Leone",0,0,0,0
"1980 Summer","Nepal",0,0,0,0
"1980 Summer","Syria",0,0,0,0
"1980 Summer","Afghanistan",0,0,0,0
"1980 Summer","Nigeria",0,0,0,0
"1980 Summer","Nicaragua",0,0,0,0
"1980 Summer","Guinea",0,0,0,0
"1980 Summer","Sri Lanka",0,0,0,0
"1980 Summer","Mozambique",0,0,0,0
"1980 Summer","Costa Rica",0,0,0,0
"1980 Summer","Luxembourg",0,0,0,0
"1980 Summer","Botswana",0,0,0,0
"1980 Winter","Russia",18,29,7,54
"1980 Winter","Germany",16,13,18,47
"1980 Winter","USA",24,4,2,30
"1980 Winter","Sweden",3,0,20,23
"1980 Winter","Norway",1,5,9,15
"1980 Winter","Finland",1,5,6,12
"1980 Winter","Switzerland",2,4,3,9
"1980 Winter","Austria",3,2,3,8
"1980 Winter","Liechtenstein",2,2,0,4
"1980 Winter","Netherlands",1,2,1,4
"1980 Winter","Italy",0,3,0,3
"1980 Winter","Hungary",0,2,0,2
"1980 Winter","Canada",0,1,1,2
"1980 Winter","UK",1,0,0,1
"1980 Winter","Japan",0,1,0,1
"1980 Winter","Bulgaria",0,0,1,1
"1980 Winter","France",0,0,1,1
"1980 Winter","Czech Republic",0,0,1,1
"1980 Winter","Lebanon",0,0,0,0
"1980 Winter","Serbia",0,0,0,0
"1980 Winter","Argentina",0,0,0,0
"1980 Winter","South Korea",0,0,0,0
"1980 Winter","Poland",0,0,0,0
"1980 Winter","China",0,0,0,0
"1980 Winter","Spain",0,0,0,0
"1980 Winter","Costa Rica",0,0,0,0
"1980 Winter","Romania",0,0,0,0
"1980 Winter","New Zealand",0,0,0,0
"1980 Winter","Boliva",0,0,0,0
"1980 Winter","Australia",0,0,0,0
"1980 Winter","Belgium",0,0,0,0
"1980 Winter","Greece",0,0,0,0
"1980 Winter","Iceland",0,0,0,0
"1980 Winter","Andorra",0,0,0,0
"1980 Winter","Cyprus",0,0,0,0
"1980 Winter","Mongolia",0,0,0,0
"1984 Summer","USA",186,116,50,352
"1984 Summer","Germany",30,75,53,158
"1984 Summer","Romania",40,31,35,106
"1984 Summer","Serbia",47,5,35,87
"1984 Summer","Canada",19,36,32,87
"1984 Summer","China",24,13,37,74
"1984 Summer","UK",9,20,42,71
"1984 Summer","France",20,16,31,67
"1984 Summer","Italy",29,6,28,63
"1984 Summer","Australia",7,14,31,52
"1984 Summer","Japan",10,8,31,49
"1984 Summer","Netherlands",20,7,14,41
"1984 Summer","South Korea",6,28,7,41
"1984 Summer","Brazil",1,33,2,36
"1984 Summer","Sweden",3,18,13,34
"1984 Summer","New Zealand",16,1,6,23
"1984 Summer","Spain",2,14,3,19
"1984 Summer","Pakistan",16,0,0,16
"1984 Summer","Switzerland",0,9,4,13
"1984 Summer","Denmark",0,3,10,13
"1984 Summer","Finland",4,2,6,12
"1984 Summer","Jamaica",0,5,2,7
"1984 Summer","Mexico",2,3,1,6
"1984 Summer","Belgium",1,2,2,5
"1984 Summer","Nigeria",0,1,4,5
"1984 Summer","Norway",0,1,3,4
"1984 Summer","Austria",1,1,1,3
"1984 Summer","Portugal",1,0,2,3
"1984 Summer","Kenya",1,0,2,3
"1984 Summer","Venezuela",0,0,3,3
"1984 Summer","Turkey",0,0,3,3
"1984 Summer","Morocco",2,0,0,2
"1984 Summer","Puerto Rico",0,1,1,2
"1984 Summer","Greece",0,1,1,2
"1984 Summer","Algeria",0,0,2,2
"1984 Summer","Ireland",0,1,0,1
"1984 Summer","Ivory Coast",0,1,0,1
"1984 Summer","Peru",0,1,0,1
"1984 Summer","Thailand",0,1,0,1
"1984 Summer","Colombia",0,1,0,1
"1984 Summer","Egypt",0,1,0,1
"1984 Summer","Syria",0,1,0,1
"1984 Summer","Zambia",0,0,1,1
"1984 Summer","Taiwan",0,0,1,1
"1984 Summer","Cameroon",0,0,1,1
"1984 Summer","Dominican Republic",0,0,1,1
"1984 Summer","Iceland",0,0,1,1
"1984 Summer","Equatorial Guinea",0,0,0,0
"1984 Summer","Grenada",0,0,0,0
"1984 Summer","Mauritania",0,0,0,0
"1984 Summer","Bahrain",0,0,0,0
"1984 Summer","Cayman Islands",0,0,0,0
"1984 Summer","Uruguay",0,0,0,0
"1984 Summer","Somalia",0,0,0,0
"1984 Summer","Solomon Islands",0,0,0,0
"1984 Summer","Swaziland",0,0,0,0
"1984 Summer","Antigua",0,0,0,0
"1984 Summer","San Marino",0,0,0,0
"1984 Summer","Iraq",0,0,0,0
"1984 Summer","Chad",0,0,0,0
"1984 Summer","Andorra",0,0,0,0
"1984 Summer","Mali",0,0,0,0
"1984 Summer","Sri Lanka",0,0,0,0
"1984 Summer","Curacao",0,0,0,0
"1984 Summer","Tunisia",0,0,0,0
"1984 Summer","Virgin Islands, British",0,0,0,0
"1984 Summer","Lesotho",0,0,0,0
"1984 Summer","Samoa",0,0,0,0
"1984 Summer","Argentina",0,0,0,0
"1984 Summer","Nepal",0,0,0,0
"1984 Summer","Philippines",0,0,0,0
"1984 Summer","Mauritius",0,0,0,0
"1984 Summer","Botswana",0,0,0,0
"1984 Summer","Bahamas",0,0,0,0
"1984 Summer","Yemen",0,0,0,0
"1984 Summer","Malawi",0,0,0,0
"1984 Summer","Lebanon",0,0,0,0
"1984 Summer","Bangladesh",0,0,0,0
"1984 Summer","Ecuador",0,0,0,0
"1984 Summer","India",0,0,0,0
"1984 Summer","Democratic Republic of the Congo",0,0,0,0
"1984 Summer","Tonga",0,0,0,0
"1984 Summer","Sudan",0,0,0,0
"1984 Summer","Fiji",0,0,0,0
"1984 Summer","Jordan",0,0,0,0
"1984 Summer","Oman",0,0,0,0
"1984 Summer","Boliva",0,0,0,0
"1984 Summer","Liechtenstein",0,0,0,0
"1984 Summer","Monaco",0,0,0,0
"1984 Summer","Paraguay",0,0,0,0
"1984 Summer","Rwanda",0,0,0,0
"1984 Summer","Gambia",0,0,0,0
"1984 Summer","Bhutan",0,0,0,0
"1984 Summer","Barbados",0,0,0,0
"1984 Summer","Togo",0,0,0,0
"1984 Summer","Nicaragua",0,0,0,0
"1984 Summer","Chile",0,0,0,0
"1984 Summer","Zimbabwe",0,0,0,0
"1984 Summer","Papua New Guinea",0,0,0,0
"1984 Summer","Central African Republic",0,0,0,0
"1984 Summer","Liberia",0,0,0,0
"1984 Summer","Benin",0,0,0,0
"1984 Summer","Belize",0,0,0,0
"1984 Summer","Saudi Arabia",0,0,0,0
"1984 Summer","Ghana",0,0,0,0
"1984 Summer","Malta",0,0,0,0
"1984 Summer","United Arab Emirates",0,0,0,0
"1984 Summer","Uganda",0,0,0,0
"1984 Summer","Panama",0,0,0,0
"1984 Summer","Costa Rica",0,0,0,0
"1984 Summer","Guatemala",0,0,0,0
"1984 Summer","Haiti",0,0,0,0
"1984 Summer","Senegal",0,0,0,0
"1984 Summer","Indonesia",0,0,0,0
"1984 Summer","Niger",0,0,0,0
"1984 Summer","Honduras",0,0,0,0
"1984 Summer","Sierra Leone",0,0,0,0
"1984 Summer","Guinea",0,0,0,0
"1984 Summer","Myanmar",0,0,0,0
"1984 Summer","Suriname",0,0,0,0
"1984 Summer","Malaysia",0,0,0,0
"1984 Summer","Trinidad",0,0,0,0
"1984 Summer","Cyprus",0,0,0,0
"1984 Summer","Guyana",0,0,0,0
"1984 Summer","Madagascar",0,0,0,0
"1984 Summer","Bermuda",0,0,0,0
"1984 Summer","Kuwait",0,0,0,0
"1984 Summer","Luxembourg",0,0,0,0
"1984 Summer","Djibouti",0,0,0,0
"1984 Summer","El Salvador",0,0,0,0
"1984 Summer","Israel",0,0,0,0
"1984 Summer","Republic of Congo",0,0,0,0
"1984 Summer","Mozambique",0,0,0,0
"1984 Summer","Gabon",0,0,0,0
"1984 Summer","Virgin Islands, US",0,0,0,0
"1984 Summer","Qatar",0,0,0,0
"1984 Summer","Tanzania",0,0,0,0
"1984 Summer","Seychelles",0,0,0,0
"1984 Winter","Russia",29,15,12,56
"1984 Winter","Germany",16,14,11,41
"1984 Winter","Sweden",7,2,21,30
"1984 Winter","Czech Republic",0,24,4,28
"1984 Winter","Finland",4,3,12,19
"1984 Winter","Norway",6,5,4,15
"1984 Winter","USA",4,5,0,9
"1984 Winter","Switzerland",2,2,4,8
"1984 Winter","Canada",2,1,1,4
"1984 Winter","France",0,1,2,3
"1984 Winter","Italy",2,0,0,2
"1984 Winter","UK",2,0,0,2
"1984 Winter","Liechtenstein",0,0,2,2
"1984 Winter","Japan",0,1,0,1
"1984 Winter","Serbia",0,1,0,1
"1984 Winter","Austria",0,0,1,1
"1984 Winter","South Korea",0,0,0,0
"1984 Winter","Costa Rica",0,0,0,0
"1984 Winter","San Marino",0,0,0,0
"1984 Winter","Mexico",0,0,0,0
"1984 Winter","China",0,0,0,0
"1984 Winter","Puerto Rico",0,0,0,0
"1984 Winter","Hungary",0,0,0,0
"1984 Winter","Cyprus",0,0,0,0
"1984 Winter","Iceland",0,0,0,0
"1984 Winter","New Zealand",0,0,0,0
"1984 Winter","Monaco",0,0,0,0
"1984 Winter","Lebanon",0,0,0,0
"1984 Winter","Turkey",0,0,0,0
"1984 Winter","Chile",0,0,0,0
"1984 Winter","Mongolia",0,0,0,0
"1984 Winter","Bulgaria",0,0,0,0
"1984 Winter","Romania",0,0,0,0
"1984 Winter","Morocco",0,0,0,0
"1984 Winter","Greece",0,0,0,0
"1984 Winter","Boliva",0,0,0,0
"1984 Winter","Poland",0,0,0,0
"1984 Winter","Australia",0,0,0,0
"1984 Winter","North Korea",0,0,0,0
"1984 Winter","Taiwan",0,0,0,0
"1984 Winter","Spain",0,0,0,0
"1984 Winter","Senegal",0,0,0,0
"1984 Winter","Argentina",0,0,0,0
"1984 Winter","Netherlands",0,0,0,0
"1984 Winter","Egypt",0,0,0,0
"1984 Winter","Belgium",0,0,0,0
"1984 Winter","Virgin Islands, British",0,0,0,0
"1984 Winter","Andorra",0,0,0,0
"1988 Summer","Russia",134,67,99,300
"1988 Summer","Germany",111,91,94,296
"1988 Summer","USA",87,66,54,207
"1988 Summer","South Korea",28,37,12,77
"1988 Summer","Serbia",15,27,21,63
"1988 Summer","Romania",8,34,16,58
"1988 Summer","UK",22,17,15,54
"1988 Summer","China",6,16,30,52
"1988 Summer","Netherlands",3,6,36,45
"1988 Summer","Hungary",20,9,15,44
"1988 Summer","Bulgaria",10,14,17,41
"1988 Summer","Australia",18,6,11,35
"1988 Summer","France",12,4,13,29
"1988 Summer","Italy",11,10,8,29
"1988 Summer","New Zealand",4,4,16,24
"1988 Summer","Canada",4,5,14,23
"1988 Summer","Brazil",1,17,5,23
"1988 Summer","Norway",2,20,0,22
"1988 Summer","Poland",2,9,10,21
"1988 Summer","Japan",4,3,13,20
"1988 Summer","Sweden",0,5,11,16
"1988 Summer","Argentina",0,1,12,13
"1988 Summer","Peru",0,12,0,12
"1988 Summer","Czech Republic",3,4,3,10
"1988 Summer","Kenya",5,2,2,9
"1988 Summer","Switzerland",0,6,2,8
"1988 Summer","Denmark",3,1,3,7
"1988 Summer","Jamaica",0,7,0,7
"1988 Summer","Spain",1,2,2,5
"1988 Summer","Finland",1,1,2,4
"1988 Summer","Morocco",1,0,2,3
"1988 Summer","Indonesia",0,3,0,3
"1988 Summer","Turkey",1,1,0,2
"1988 Summer","Mexico",0,0,2,2
"1988 Summer","Belgium",0,0,2,2
"1988 Summer","Austria",1,0,0,1
"1988 Summer","Portugal",1,0,0,1
"1988 Summer","Suriname",1,0,0,1
"1988 Summer","Senegal",0,1,0,1
"1988 Summer","Chile",0,1,0,1
"1988 Summer","Virgin Islands, US",0,1,0,1
"1988 Summer","Iran",0,1,0,1
"1988 Summer","Costa Rica",0,1,0,1
"1988 Summer","Curacao",0,1,0,1
"1988 Summer","Philippines",0,0,1,1
"1988 Summer","Djibouti",0,0,1,1
"1988 Summer","Greece",0,0,1,1
"1988 Summer","Colombia",0,0,1,1
"1988 Summer","Mongolia",0,0,1,1
"1988 Summer","Thailand",0,0,1,1
"1988 Summer","Pakistan",0,0,1,1
"1988 Summer","Maldives",0,0,0,0
"1988 Summer","Papua New Guinea",0,0,0,0
"1988 Summer","Myanmar",0,0,0,0
"1988 Summer","Equatorial Guinea",0,0,0,0
"1988 Summer","United Arab Emirates",0,0,0,0
"1988 Summer","Uganda",0,0,0,0
"1988 Summer","Central African Republic",0,0,0,0
"1988 Summer","Bangladesh",0,0,0,0
"1988 Summer","Qatar",0,0,0,0
"1988 Summer","Democratic Republic of the Congo",0,0,0,0
"1988 Summer","Panama",0,0,0,0
"1988 Summer","Cameroon",0,0,0,0
"1988 Summer","Barbados",0,0,0,0
"1988 Summer","Venezuela",0,0,0,0
"1988 Summer","Togo",0,0,0,0
"1988 Summer","Gambia",0,0,0,0
"1988 Summer","Lebanon",0,0,0,0
"1988 Summer","Bahamas",0,0,0,0
"1988 Summer","Gabon",0,0,0,0
"1988 Summer","Trinidad",0,0,0,0
"1988 Summer","Vanuatu",0,0,0,0
"1988 Summer","Niger",0,0,0,0
"1988 Summer","Sri Lanka",0,0,0,0
"1988 Summer","Guatemala",0,0,0,0
"1988 Summer","Republic of Congo",0,0,0,0
"1988 Summer","Andorra",0,0,0,0
"1988 Summer","Algeria",0,0,0,0
"1988 Summer","Guinea",0,0,0,0
"1988 Summer","Ecuador",0,0,0,0
"1988 Summer","Nigeria",0,0,0,0
"1988 Summer","Iraq",0,0,0,0
"1988 Summer","Saint Vincent",0,0,0,0
"1988 Summer","Cyprus",0,0,0,0
"1988 Summer","Tunisia",0,0,0,0
"1988 Summer","Liberia",0,0,0,0
"1988 Summer","Tonga",0,0,0,0
"1988 Summer","Nepal",0,0,0,0
"1988 Summer","Virgin Islands, British",0,0,0,0
"1988 Summer","Swaziland",0,0,0,0
"1988 Summer","Fiji",0,0,0,0
"1988 Summer","Samoa",0,0,0,0
"1988 Summer","American Samoa",0,0,0,0
"1988 Summer","Kuwait",0,0,0,0
"1988 Summer","Mali",0,0,0,0
"1988 Summer","Oman",0,0,0,0
"1988 Summer","Libya",0,0,0,0
"1988 Summer","Jordan",0,0,0,0
"1988 Summer","Paraguay",0,0,0,0
"1988 Summer","Grenada",0,0,0,0
"1988 Summer","Chad",0,0,0,0
"1988 Summer","Botswana",0,0,0,0
"1988 Summer","Haiti",0,0,0,0
"1988 Summer","Somalia",0,0,0,0
"1988 Summer","Solomon Islands",0,0,0,0
"1988 Summer","Lesotho",0,0,0,0
"1988 Summer","Ghana",0,0,0,0
"1988 Summer","Malaysia",0,0,0,0
"1988 Summer","Guam",0,0,0,0
"1988 Summer","Liechtenstein",0,0,0,0
"1988 Summer","Puerto Rico",0,0,0,0
"1988 Summer","Uruguay",0,0,0,0
"1988 Summer","Aruba",0,0,0,0
"1988 Summer","San Marino",0,0,0,0
"1988 Summer","Cook Islands",0,0,0,0
"1988 Summer","Cayman Islands",0,0,0,0
"1988 Summer","Mauritania",0,0,0,0
"1988 Summer","Saudi Arabia",0,0,0,0
"1988 Summer","Bermuda",0,0,0,0
"1988 Summer","El Salvador",0,0,0,0
"1988 Summer","Mauritius",0,0,0,0
"1988 Summer","Tanzania",0,0,0,0
"1988 Summer","Sierra Leone",0,0,0,0
"1988 Summer","Ivory Coast",0,0,0,0
"1988 Summer","Malta",0,0,0,0
"1988 Summer","India",0,0,0,0
"1988 Summer","Guyana",0,0,0,0
"1988 Summer","Bahrain",0,0,0,0
"1988 Summer","Belize",0,0,0,0
"1988 Summer","Monaco",0,0,0,0
"1988 Summer","Israel",0,0,0,0
"1988 Summer","Afghanistan",0,0,0,0
"1988 Summer","Honduras",0,0,0,0
"1988 Summer","Iceland",0,0,0,0
"1988 Summer","Rwanda",0,0,0,0
"1988 Summer","Sudan",0,0,0,0
"1988 Summer","Zimbabwe",0,0,0,0
"1988 Summer","Taiwan",0,0,0,0
"1988 Summer","Mozambique",0,0,0,0
"1988 Summer","Luxembourg",0,0,0,0
"1988 Summer","Boliva",0,0,0,0
"1988 Summer","Egypt",0,0,0,0
"1988 Summer","Syria",0,0,0,0
"1988 Summer","Dominican Republic",0,0,0,0
"1988 Summer","Laos",0,0,0,0
"1988 Summer","Benin",0,0,0,0
"1988 Summer","Bhutan",0,0,0,0
"1988 Summer","Yemen",0,0,0,0
"1988 Summer","Ireland",0,0,0,0
"1988 Summer","Burkina Faso",0,0,0,0
"1988 Summer","Malawi",0,0,0,0
"1988 Summer","Angola",0,0,0,0
"1988 Summer","Antigua",0,0,0,0
"1988 Summer","Zambia",0,0,0,0
"1988 Summer","Vietnam",0,0,0,0
"1988 Winter","Russia",40,14,12,66
"1988 Winter","Germany",14,22,10,46
"1988 Winter","Finland",7,22,5,34
"1988 Winter","Sweden",7,0,23,30
"1988 Winter","Switzerland",8,7,5,20
"1988 Winter","Austria",3,5,4,12
"1988 Winter","Norway",0,6,5,11
"1988 Winter","Italy",2,1,5,8
"1988 Winter","Netherlands",3,2,2,7
"1988 Winter","USA",2,1,4,7
"1988 Winter","Serbia",0,5,1,6
"1988 Winter","Canada",0,2,4,6
"1988 Winter","Czech Republic",0,1,5,6
"1988 Winter","France",1,0,1,2
"1988 Winter","Liechtenstein",0,0,1,1
"1988 Winter","Japan",0,0,1,1
"1988 Winter","Mexico",0,0,0,0
"1988 Winter","Puerto Rico",0,0,0,0
"1988 Winter","Spain",0,0,0,0
"1988 Winter","Denmark",0,0,0,0
"1988 Winter","Belgium",0,0,0,0
"1988 Winter","Morocco",0,0,0,0
"1988 Winter","Turkey",0,0,0,0
"1988 Winter","Guatemala",0,0,0,0
"1988 Winter","Virgin Islands, US",0,0,0,0
"1988 Winter","Fiji",0,0,0,0
"1988 Winter","Taiwan",0,0,0,0
"1988 Winter","Mongolia",0,0,0,0
"1988 Winter","Guam",0,0,0,0
"1988 Winter","Jamaica",0,0,0,0
"1988 Winter","Chile",0,0,0,0
"1988 Winter","South Korea",0,0,0,0
"1988 Winter","Argentina",0,0,0,0
"1988 Winter","Portugal",0,0,0,0
"1988 Winter","Andorra",0,0,0,0
"1988 Winter","Hungary",0,0,0,0
"1988 Winter","Romania",0,0,0,0
"1988 Winter","Iceland",0,0,0,0
"1988 Winter","Costa Rica",0,0,0,0
"1988 Winter","Bulgaria",0,0,0,0
"1988 Winter","Lebanon",0,0,0,0
"1988 Winter","Philippines",0,0,0,0
"1988 Winter","North Korea",0,0,0,0
"1988 Winter","New Zealand",0,0,0,0
"1988 Winter","Curacao",0,0,0,0
"1988 Winter","Luxembourg",0,0,0,0
"1988 Winter","Australia",0,0,0,0
"1988 Winter","Cyprus",0,0,0,0
"1988 Winter","Boliva",0,0,0,0
"1988 Winter","Monaco",0,0,0,0
"1988 Winter","Greece",0,0,0,0
"1988 Winter","India",0,0,0,0
"1988 Winter","Poland",0,0,0,0
"1988 Winter","UK",0,0,0,0
"1988 Winter","China",0,0,0,0
"1988 Winter","San Marino",0,0,0,0
"1992 Summer","USA",89,50,85,224
"1992 Summer","Russia",92,61,67,220
"1992 Summer","Germany",81,57,60,198
"1992 Summer","China",18,45,19,82
"1992 Summer","Spain",48,19,2,69
"1992 Summer","Cuba",42,13,14,69
"1992 Summer","Australia",14,27,16,57
"1992 Summer","France",9,5,43,57
"1992 Summer","Romania",8,31,14,53
"1992 Summer","UK",8,3,39,50
"1992 Summer","South Korea",28,5,16,49
"1992 Summer","Japan",3,8,36,47
"1992 Summer","Poland",5,22,19,46
"1992 Summer","Italy",21,10,14,45
"1992 Summer","Hungary",14,23,8,45
"1992 Summer","Canada",27,5,12,44
"1992 Summer","Sweden",1,27,7,35
"1992 Summer","Netherlands",5,20,8,33
"1992 Summer","Norway",2,20,1,23
"1992 Summer","Taiwan",0,20,0,20
"1992 Summer","Ghana",0,0,20,20
"1992 Summer","Bulgaria",3,7,7,17
"1992 Summer","Pakistan",0,0,16,16
"1992 Summer","New Zealand",1,9,5,15
"1992 Summer","Croatia",0,12,3,15
"1992 Summer","Brazil",13,1,0,14
"1992 Summer","Denmark",3,2,9,14
"1992 Summer","Lithuania",1,0,12,13
"1992 Summer","Nigeria",0,7,4,11
"1992 Summer","North Korea",4,0,6,10
"1992 Summer","Czech Republic",4,3,1,8
"1992 Summer","Kenya",2,4,2,8
"1992 Summer","Finland",1,4,2,7
"1992 Summer","Indonesia",2,3,1,6
"1992 Summer","Turkey",2,2,2,6
"1992 Summer","Austria",0,6,0,6
"1992 Summer","Slovenia",0,0,6,6
"1992 Summer","Jamaica",0,3,1,4
"1992 Summer","Morocco",1,1,1,3
"1992 Summer","Ethiopia",1,0,2,3
"1992 Summer","Estonia",1,0,2,3
"1992 Summer","South Africa",0,3,0,3
"1992 Summer","Latvia",0,2,1,3
"1992 Summer","Individual Olympic Athletes",0,1,2,3
"1992 Summer","Belgium",0,1,2,3
"1992 Summer","Iran",0,1,2,3
"1992 Summer","Greece",2,0,0,2
"1992 Summer","Ireland",1,1,0,2
"1992 Summer","Algeria",1,0,1,2
"1992 Summer","Namibia",0,2,0,2
"1992 Summer","Israel",0,1,1,2
"1992 Summer","Argentina",0,0,2,2
"1992 Summer","Malaysia",0,0,2,2
"1992 Summer","Mongolia",0,0,2,2
"1992 Summer","Switzerland",1,0,0,1
"1992 Summer","Mexico",0,1,0,1
"1992 Summer","Peru",0,1,0,1
"1992 Summer","Philippines",0,0,1,1
"1992 Summer","Thailand",0,0,1,1
"1992 Summer","Puerto Rico",0,0,1,1
"1992 Summer","Qatar",0,0,1,1
"1992 Summer","Bahamas",0,0,1,1
"1992 Summer","Colombia",0,0,1,1
"1992 Summer","Suriname",0,0,1,1
"1992 Summer","Sierra Leone",0,0,0,0
"1992 Summer","Mozambique",0,0,0,0
"1992 Summer","Equatorial Guinea",0,0,0,0
"1992 Summer","Burkina Faso",0,0,0,0
"1992 Summer","Bhutan",0,0,0,0
"1992 Summer","Saudi Arabia",0,0,0,0
"1992 Summer","Sri Lanka",0,0,0,0
"1992 Summer","Bosnia and Herzegovina",0,0,0,0
"1992 Summer","Zimbabwe",0,0,0,0
"1992 Summer","Bermuda",0,0,0,0
"1992 Summer","Luxembourg",0,0,0,0
"1992 Summer","Chile",0,0,0,0
"1992 Summer","American Samoa",0,0,0,0
"1992 Summer","Madagascar",0,0,0,0
"1992 Summer","Djibouti",0,0,0,0
"1992 Summer","Curacao",0,0,0,0
"1992 Summer","Gambia",0,0,0,0
"1992 Summer","Papua New Guinea",0,0,0,0
"1992 Summer","Bangladesh",0,0,0,0
"1992 Summer","Solomon Islands",0,0,0,0
"1992 Summer","Seychelles",0,0,0,0
"1992 Summer","Dominican Republic",0,0,0,0
"1992 Summer","Senegal",0,0,0,0
"1992 Summer","Sudan",0,0,0,0
"1992 Summer","Malawi",0,0,0,0
"1992 Summer","Bahrain",0,0,0,0
"1992 Summer","Uruguay",0,0,0,0
"1992 Summer","Cayman Islands",0,0,0,0
"1992 Summer","San Marino",0,0,0,0
"1992 Summer","Antigua",0,0,0,0
"1992 Summer","Mali",0,0,0,0
"1992 Summer","Venezuela",0,0,0,0
"1992 Summer","Maldives",0,0,0,0
"1992 Summer","Honduras",0,0,0,0
"1992 Summer","Liechtenstein",0,0,0,0
"1992 Summer","Monaco",0,0,0,0
"1992 Summer","Yemen",0,0,0,0
"1992 Summer","Rwanda",0,0,0,0
"1992 Summer","Virgin Islands, US",0,0,0,0
"1992 Summer","Uganda",0,0,0,0
"1992 Summer","Andorra",0,0,0,0
"1992 Summer","United Arab Emirates",0,0,0,0
"1992 Summer","Lebanon",0,0,0,0
"1992 Summer","Guatemala",0,0,0,0
"1992 Summer","Cyprus",0,0,0,0
"1992 Summer","Albania",0,0,0,0
"1992 Summer","Virgin Islands, British",0,0,0,0
"1992 Summer","Nepal",0,0,0,0
"1992 Summer","Iraq",0,0,0,0
"1992 Summer","Guam",0,0,0,0
"1992 Summer","Saint Vincent",0,0,0,0
"1992 Summer","Samoa",0,0,0,0
"1992 Summer","Republic of Congo",0,0,0,0
"1992 Summer","Ecuador",0,0,0,0
"1992 Summer","Laos",0,0,0,0
"1992 Summer","Cook Islands",0,0,0,0
"1992 Summer","Botswana",0,0,0,0
"1992 Summer","Guyana",0,0,0,0
"1992 Summer","Ivory Coast",0,0,0,0
"1992 Summer","Tanzania",0,0,0,0
"1992 Summer","Vanuatu",0,0,0,0
"1992 Summer","Chad",0,0,0,0
"1992 Summer","Portugal",0,0,0,0
"1992 Summer","Myanmar",0,0,0,0
"1992 Summer","Barbados",0,0,0,0
"1992 Summer","Costa Rica",0,0,0,0
"1992 Summer","Guinea",0,0,0,0
"1992 Summer","Malta",0,0,0,0
"1992 Summer","Mauritius",0,0,0,0
"1992 Summer","El Salvador",0,0,0,0
"1992 Summer","Libya",0,0,0,0
"1992 Summer","Grenada",0,0,0,0
"1992 Summer","Togo",0,0,0,0
"1992 Summer","Mauritania",0,0,0,0
"1992 Summer","Angola",0,0,0,0
"1992 Summer","Haiti",0,0,0,0
"1992 Summer","Central African Republic",0,0,0,0
"1992 Summer","Kuwait",0,0,0,0
"1992 Summer","India",0,0,0,0
"1992 Summer","Iceland",0,0,0,0
"1992 Summer","Tunisia",0,0,0,0
"1992 Summer","Niger",0,0,0,0
"1992 Summer","Zambia",0,0,0,0
"1992 Summer","Jordan",0,0,0,0
"1992 Summer","Oman",0,0,0,0
"1992 Summer","Cameroon",0,0,0,0
"1992 Summer","Swaziland",0,0,0,0
"1992 Summer","Vietnam",0,0,0,0
"1992 Summer","Tonga",0,0,0,0
"1992 Summer","Egypt",0,0,0,0
"1992 Summer","Gabon",0,0,0,0
"1992 Summer","Paraguay",0,0,0,0
"1992 Summer","Boliva",0,0,0,0
"1992 Summer","Trinidad",0,0,0,0
"1992 Summer","Belize",0,0,0,0
"1992 Summer","Aruba",0,0,0,0
"1992 Summer","Panama",0,0,0,0
"1992 Summer","Democratic Republic of the Congo",0,0,0,0
"1992 Summer","Fiji",0,0,0,0
"1992 Summer","Lesotho",0,0,0,0
"1992 Summer","Syria",0,0,0,0
"1992 Summer","Benin",0,0,0,0
"1992 Summer","Nicaragua",0,0,0,0
"1992 Winter","Russia",35,10,14,59
"1992 Winter","Germany",14,17,7,38
"1992 Winter","Canada",5,28,3,36
"1992 Winter","Austria",9,10,10,29
"1992 Winter","Czech Republic",0,0,27,27
"1992 Winter","Norway",9,10,5,24
"1992 Winter","Italy",4,9,8,21
"1992 Winter","USA",5,7,2,14
"1992 Winter","Finland",6,1,6,13
"1992 Winter","France",5,6,1,12
"1992 Winter","Japan",3,2,7,12
"1992 Winter","South Korea",5,1,1,7
"1992 Winter","Switzerland",2,0,5,7
"1992 Winter","Sweden",1,0,6,7
"1992 Winter","Netherlands",1,1,2,4
"1992 Winter","China",0,3,0,3
"1992 Winter","Luxembourg",0,2,0,2
"1992 Winter","New Zealand",0,1,0,1
"1992 Winter","Spain",0,0,1,1
"1992 Winter","North Korea",0,0,1,1
"1992 Winter","Taiwan",0,0,0,0
"1992 Winter","Australia",0,0,0,0
"1992 Winter","Bulgaria",0,0,0,0
"1992 Winter","Ireland",0,0,0,0
"1992 Winter","Turkey",0,0,0,0
"1992 Winter","Monaco",0,0,0,0
"1992 Winter","Puerto Rico",0,0,0,0
"1992 Winter","Andorra",0,0,0,0
"1992 Winter","Jamaica",0,0,0,0
"1992 Winter","San Marino",0,0,0,0
"1992 Winter","Liechtenstein",0,0,0,0
"1992 Winter","Iceland",0,0,0,0
"1992 Winter","Curacao",0,0,0,0
"1992 Winter","UK",0,0,0,0
"1992 Winter","Argentina",0,0,0,0
"1992 Winter","Boliva",0,0,0,0
"1992 Winter","Estonia",0,0,0,0
"1992 Winter","Philippines",0,0,0,0
"1992 Winter","Lebanon",0,0,0,0
"1992 Winter","Croatia",0,0,0,0
"1992 Winter","Poland",0,0,0,0
"1992 Winter","Lithuania",0,0,0,0
"1992 Winter","Senegal",0,0,0,0
"1992 Winter","Cyprus",0,0,0,0
"1992 Winter","India",0,0,0,0
"1992 Winter","Greece",0,0,0,0
"1992 Winter","Slovenia",0,0,0,0
"1992 Winter","Virgin Islands, US",0,0,0,0
"1992 Winter","Romania",0,0,0,0
"1992 Winter","Swaziland",0,0,0,0
"1992 Winter","Brazil",0,0,0,0
"1992 Winter","Mexico",0,0,0,0
"1992 Winter","Honduras",0,0,0,0
"1992 Winter","Hungary",0,0,0,0
"1992 Winter","Algeria",0,0,0,0
"1992 Winter","Mongolia",0,0,0,0
"1992 Winter","Costa Rica",0,0,0,0
"1992 Winter","Chile",0,0,0,0
"1992 Winter","Belgium",0,0,0,0
"1992 Winter","Bermuda",0,0,0,0
"1992 Winter","Latvia",0,0,0,0
"1992 Winter","Morocco",0,0,0,0
"1992 Winter","Denmark",0,0,0,0
"1992 Winter","Serbia",0,0,0,0
"1994 Winter","Germany",18,10,12,40
"1994 Winter","Canada",3,29,5,37
"1994 Winter","Russia",19,13,4,36
"1994 Winter","Italy",14,6,12,32
"1994 Winter","Norway",8,17,5,30
"1994 Winter","Finland",0,1,29,30
"1994 Winter","Sweden",23,1,0,24
"1994 Winter","USA",6,8,5,19
"1994 Winter","Switzerland",4,8,4,16
"1994 Winter","Austria",2,3,7,12
"1994 Winter","France",0,1,10,11
"1994 Winter","Japan",3,5,2,10
"1994 Winter","South Korea",7,1,1,9
"1994 Winter","Netherlands",0,1,3,4
"1994 Winter","Australia",0,0,4,4
"1994 Winter","Kazakhstan",1,2,0,3
"1994 Winter","China",0,1,2,3
"1994 Winter","UK",0,0,3,3
"1994 Winter","Slovenia",0,0,3,3
"1994 Winter","Ukraine",1,0,1,2
"1994 Winter","Belarus",0,2,0,2
"1994 Winter","Uzbekistan",1,0,0,1
"1994 Winter","Turkey",0,0,0,0
"1994 Winter","Bulgaria",0,0,0,0
"1994 Winter","Czech Republic",0,0,0,0
"1994 Winter","Latvia",0,0,0,0
"1994 Winter","Kyrgyzstan",0,0,0,0
"1994 Winter","Bosnia and Herzegovina",0,0,0,0
"1994 Winter","Israel",0,0,0,0
"1994 Winter","Poland",0,0,0,0
"1994 Winter","Greece",0,0,0,0
"1994 Winter","Bermuda",0,0,0,0
"1994 Winter","Belgium",0,0,0,0
"1994 Winter","Chile",0,0,0,0
"1994 Winter","Mongolia",0,0,0,0
"1994 Winter","Brazil",0,0,0,0
"1994 Winter","Georgia",0,0,0,0
"1994 Winter","Virgin Islands, US",0,0,0,0
"1994 Winter","American Samoa",0,0,0,0
"1994 Winter","Romania",0,0,0,0
"1994 Winter","Croatia",0,0,0,0
"1994 Winter","Lithuania",0,0,0,0
"1994 Winter","Senegal",0,0,0,0
"1994 Winter","Trinidad",0,0,0,0
"1994 Winter","Mexico",0,0,0,0
"1994 Winter","Denmark",0,0,0,0
"1994 Winter","Hungary",0,0,0,0
"1994 Winter","Taiwan",0,0,0,0
"1994 Winter","South Africa",0,0,0,0
"1994 Winter","Estonia",0,0,0,0
"1994 Winter","Iceland",0,0,0,0
"1994 Winter","Liechtenstein",0,0,0,0
"1994 Winter","Moldova",0,0,0,0
"1994 Winter","New Zealand",0,0,0,0
"1994 Winter","Luxembourg",0,0,0,0
"1994 Winter","Monaco",0,0,0,0
"1994 Winter","Portugal",0,0,0,0
"1994 Winter","Fiji",0,0,0,0
"1994 Winter","Jamaica",0,0,0,0
"1994 Winter","Argentina",0,0,0,0
"1994 Winter","Andorra",0,0,0,0
"1994 Winter","Cyprus",0,0,0,0
"1994 Winter","Spain",0,0,0,0
"1994 Winter","Puerto Rico",0,0,0,0
"1994 Winter","Slovakia",0,0,0,0
"1994 Winter","Armenia",0,0,0,0
"1994 Winter","San Marino",0,0,0,0
"1996 Summer","USA",159,48,52,259
"1996 Summer","Australia",32,16,84,132
"1996 Summer","Germany",42,35,47,124
"1996 Summer","Russia",36,45,34,115
"1996 Summer","China",20,70,17,107
"1996 Summer","Netherlands",38,9,26,73
"1996 Summer","Italy",19,24,28,71
"1996 Summer","Spain",23,21,22,66
"1996 Summer","South Korea",10,49,7,66
"1996 Summer","Brazil",5,15,43,63
"1996 Summer","Cuba",37,8,10,55
"1996 Summer","France",21,10,20,51
"1996 Summer","Canada",8,30,12,50
"1996 Summer","Hungary",8,9,26,43
"1996 Summer","Japan",3,26,13,42
"1996 Summer","Romania",13,10,15,38
"1996 Summer","Ukraine",10,5,19,34
"1996 Summer","Sweden",3,23,5,31
"1996 Summer","Croatia",16,12,0,28
"1996 Summer","UK",2,15,9,26
"1996 Summer","Serbia",1,12,13,26
"1996 Summer","Nigeria",17,4,3,24
"1996 Summer","Denmark",21,1,1,23
"1996 Summer","Norway",2,3,18,23
"1996 Summer","Belarus",1,6,16,23
"1996 Summer","Poland",7,8,7,22
"1996 Summer","Bulgaria",3,12,6,21
"1996 Summer","Argentina",0,19,1,20
"1996 Summer","Jamaica",1,3,12,16
"1996 Summer","Czech Republic",4,5,4,13
"1996 Summer","Switzerland",5,6,0,11
"1996 Summer","Kazakhstan",3,4,4,11
"1996 Summer","Lithuania",0,0,11,11
"1996 Summer","New Zealand",3,2,4,9
"1996 Summer","Greece",4,4,0,8
"1996 Summer","Kenya",1,4,3,8
"1996 Summer","Turkey",4,1,1,6
"1996 Summer","Belgium",2,2,2,6
"1996 Summer","Indonesia",2,1,3,6
"1996 Summer","South Africa",3,1,1,5
"1996 Summer","North Korea",2,1,2,5
"1996 Summer","Bahamas",0,5,0,5
"1996 Summer","Ireland",3,0,1,4
"1996 Summer","Finland",1,2,1,4
"1996 Summer","Ethiopia",2,0,1,3
"1996 Summer","Algeria",2,0,1,3
"1996 Summer","Slovakia",1,1,1,3
"1996 Summer","Iran",1,1,1,3
"1996 Summer","Portugal",1,0,2,3
"1996 Summer","Moldova",0,2,1,3
"1996 Summer","Malaysia",0,2,1,3
"1996 Summer","Austria",0,1,2,3
"1996 Summer","Armenia",1,1,0,2
"1996 Summer","Thailand",1,0,1,2
"1996 Summer","Slovenia",0,2,0,2
"1996 Summer","Namibia",0,2,0,2
"1996 Summer","Uzbekistan",0,1,1,2
"1996 Summer","Georgia",0,0,2,2
"1996 Summer","Morocco",0,0,2,2
"1996 Summer","Trinidad",0,0,2,2
"1996 Summer","Ecuador",1,0,0,1
"1996 Summer","Costa Rica",1,0,0,1
"1996 Summer","Burundi",1,0,0,1
"1996 Summer","Syria",1,0,0,1
"1996 Summer","Latvia",0,1,0,1
"1996 Summer","Taiwan",0,1,0,1
"1996 Summer","Zambia",0,1,0,1
"1996 Summer","Philippines",0,1,0,1
"1996 Summer","Tonga",0,1,0,1
"1996 Summer","Azerbaijan",0,1,0,1
"1996 Summer","Mongolia",0,0,1,1
"1996 Summer","Mozambique",0,0,1,1
"1996 Summer","Mexico",0,0,1,1
"1996 Summer","Tunisia",0,0,1,1
"1996 Summer","Puerto Rico",0,0,1,1
"1996 Summer","India",0,0,1,1
"1996 Summer","Uganda",0,0,1,1
"1996 Summer","Israel",0,0,1,1
"1996 Summer","Republic of Congo",0,0,0,0
"1996 Summer","Belize",0,0,0,0
"1996 Summer","Tajikistan",0,0,0,0
"1996 Summer","Lebanon",0,0,0,0
"1996 Summer","Luxembourg",0,0,0,0
"1996 Summer","Cameroon",0,0,0,0
"1996 Summer","Papua New Guinea",0,0,0,0
"1996 Summer","San Marino",0,0,0,0
"1996 Summer","Virgin Islands, US",0,0,0,0
"1996 Summer","Lesotho",0,0,0,0
"1996 Summer","Qatar",0,0,0,0
"1996 Summer","American Samoa",0,0,0,0
"1996 Summer","Pakistan",0,0,0,0
"1996 Summer","Benin",0,0,0,0
"1996 Summer","Honduras",0,0,0,0
"1996 Summer","Nauru",0,0,0,0
"1996 Summer","Bhutan",0,0,0,0
"1996 Summer","Cambodia",0,0,0,0
"1996 Summer","Tanzania",0,0,0,0
"1996 Summer","Mali",0,0,0,0
"1996 Summer","Oman",0,0,0,0
"1996 Summer","Nepal",0,0,0,0
"1996 Summer","Cook Islands",0,0,0,0
"1996 Summer","Democratic Republic of the Congo",0,0,0,0
"1996 Summer","Myanmar",0,0,0,0
"1996 Summer","Fiji",0,0,0,0
"1996 Summer","Uruguay",0,0,0,0
"1996 Summer","Palestine",0,0,0,0
"1996 Summer","Seychelles",0,0,0,0
"1996 Summer","Andorra",0,0,0,0
"1996 Summer","Malawi",0,0,0,0
"1996 Summer","Haiti",0,0,0,0
"1996 Summer","Cape Verde",0,0,0,0
"1996 Summer","Estonia",0,0,0,0
"1996 Summer","United Arab Emirates",0,0,0,0
"1996 Summer","Egypt",0,0,0,0
"1996 Summer","Yemen",0,0,0,0
"1996 Summer","Guam",0,0,0,0
"1996 Summer","Libya",0,0,0,0
"1996 Summer","Burkina Faso",0,0,0,0
"1996 Summer","Kyrgyzstan",0,0,0,0
"1996 Summer","Central African Republic",0,0,0,0
"1996 Summer","Rwanda",0,0,0,0
"1996 Summer","Monaco",0,0,0,0
"1996 Summer","Saudi Arabia",0,0,0,0
"1996 Summer","Cyprus",0,0,0,0
"1996 Summer","Afghanistan",0,0,0,0
"1996 Summer","Togo",0,0,0,0
"1996 Summer","Vietnam",0,0,0,0
"1996 Summer","Samoa",0,0,0,0
"1996 Summer","Nicaragua",0,0,0,0
"1996 Summer","Solomon Islands",0,0,0,0
"1996 Summer","Bosnia and Herzegovina",0,0,0,0
"1996 Summer","Peru",0,0,0,0
"1996 Summer","Aruba",0,0,0,0
"1996 Summer","Somalia",0,0,0,0
"1996 Summer","Brunei",0,0,0,0
"1996 Summer","Saint Vincent",0,0,0,0
"1996 Summer","Gabon",0,0,0,0
"1996 Summer","Jordan",0,0,0,0
"1996 Summer","Maldives",0,0,0,0
"1996 Summer","Bahrain",0,0,0,0
"1996 Summer","Gambia",0,0,0,0
"1996 Summer","Saint Lucia",0,0,0,0
"1996 Summer","Virgin Islands, British",0,0,0,0
"1996 Summer","Antigua",0,0,0,0
"1996 Summer","Madagascar",0,0,0,0
"1996 Summer","Ghana",0,0,0,0
"1996 Summer","Dominican Republic",0,0,0,0
"1996 Summer","Vanuatu",0,0,0,0
"1996 Summer","Djibouti",0,0,0,0
"1996 Summer","Liberia",0,0,0,0
"1996 Summer","Swaziland",0,0,0,0
"1996 Summer","Comoros",0,0,0,0
"1996 Summer","Chad",0,0,0,0
"1996 Summer","Malta",0,0,0,0
"1996 Summer","Liechtenstein",0,0,0,0
"1996 Summer","Guyana",0,0,0,0
"1996 Summer","El Salvador",0,0,0,0
"1996 Summer","Panama",0,0,0,0
"1996 Summer","Boliva",0,0,0,0
"1996 Summer","Macedonia",0,0,0,0
"1996 Summer","Dominica",0,0,0,0
"1996 Summer","Laos",0,0,0,0
"1996 Summer","Saint Kitts",0,0,0,0
"1996 Summer","Zimbabwe",0,0,0,0
"1996 Summer","Guinea",0,0,0,0
"1996 Summer","Venezuela",0,0,0,0
"1996 Summer","Mauritius",0,0,0,0
"1996 Summer","Sri Lanka",0,0,0,0
"1996 Summer","Iraq",0,0,0,0
"1996 Summer","Bermuda",0,0,0,0
"1996 Summer","Paraguay",0,0,0,0
"1996 Summer","Guatemala",0,0,0,0
"1996 Summer","Sierra Leone",0,0,0,0
"1996 Summer","Guinea-Bissau",0,0,0,0
"1996 Summer","Sao Tome and Principe",0,0,0,0
"1996 Summer","Angola",0,0,0,0
"1996 Summer","Kuwait",0,0,0,0
"1996 Summer","Sudan",0,0,0,0
"1996 Summer","Turkmenistan",0,0,0,0
"1996 Summer","Chile",0,0,0,0
"1996 Summer","Cayman Islands",0,0,0,0
"1996 Summer","Senegal",0,0,0,0
"1996 Summer","Suriname",0,0,0,0
"1996 Summer","Grenada",0,0,0,0
"1996 Summer","Barbados",0,0,0,0
"1996 Summer","Niger",0,0,0,0
"1996 Summer","Mauritania",0,0,0,0
"1996 Summer","Equatorial Guinea",0,0,0,0
"1996 Summer","Iceland",0,0,0,0
"1996 Summer","Bangladesh",0,0,0,0
"1996 Summer","Colombia",0,0,0,0
"1996 Summer","Ivory Coast",0,0,0,0
"1996 Summer","Curacao",0,0,0,0
"1996 Summer","Botswana",0,0,0,0
"1996 Summer","Albania",0,0,0,0
"1998 Winter","Finland",2,7,49,58
"1998 Winter","Russia",14,32,6,52
"1998 Winter","Canada",14,28,7,49
"1998 Winter","Germany",22,12,10,44
"1998 Winter","Norway",13,15,12,40
"1998 Winter","USA",25,4,5,34
"1998 Winter","Czech Republic",21,1,1,23
"1998 Winter","Austria",3,5,12,20
"1998 Winter","Italy",3,9,5,17
"1998 Winter","France",2,1,12,15
"1998 Winter","Switzerland",6,5,3,14
"1998 Winter","China",0,9,5,14
"1998 Winter","Japan",8,1,4,13
"1998 Winter","South Korea",6,4,2,12
"1998 Winter","Netherlands",5,4,2,11
"1998 Winter","Sweden",0,2,5,7
"1998 Winter","Denmark",0,5,0,5
"1998 Winter","UK",0,0,4,4
"1998 Winter","Belarus",0,0,2,2
"1998 Winter","Kazakhstan",0,0,2,2
"1998 Winter","Bulgaria",1,0,0,1
"1998 Winter","Ukraine",0,1,0,1
"1998 Winter","Australia",0,0,1,1
"1998 Winter","Belgium",0,0,1,1
"1998 Winter","North Korea",0,0,0,0
"1998 Winter","India",0,0,0,0
"1998 Winter","Bermuda",0,0,0,0
"1998 Winter","Kyrgyzstan",0,0,0,0
"1998 Winter","Chile",0,0,0,0
"1998 Winter","Israel",0,0,0,0
"1998 Winter","Luxembourg",0,0,0,0
"1998 Winter","Latvia",0,0,0,0
"1998 Winter","Bosnia and Herzegovina",0,0,0,0
"1998 Winter","Macedonia",0,0,0,0
"1998 Winter","Taiwan",0,0,0,0
"1998 Winter","Kenya",0,0,0,0
"1998 Winter","Trinidad",0,0,0,0
"1998 Winter","Greece",0,0,0,0
"1998 Winter","Liechtenstein",0,0,0,0
"1998 Winter","Uruguay",0,0,0,0
"1998 Winter","Iran",0,0,0,0
"1998 Winter","Croatia",0,0,0,0
"1998 Winter","Andorra",0,0,0,0
"1998 Winter","Estonia",0,0,0,0
"1998 Winter","Azerbaijan",0,0,0,0
"1998 Winter","Argentina",0,0,0,0
"1998 Winter","Georgia",0,0,0,0
"1998 Winter","Turkey",0,0,0,0
"1998 Winter","Mongolia",0,0,0,0
"1998 Winter","Jamaica",0,0,0,0
"1998 Winter","Ireland",0,0,0,0
"1998 Winter","Romania",0,0,0,0
"1998 Winter","Iceland",0,0,0,0
"1998 Winter","Monaco",0,0,0,0
"1998 Winter","Portugal",0,0,0,0
"1998 Winter","Cyprus",0,0,0,0
"1998 Winter","New Zealand",0,0,0,0
"1998 Winter","Venezuela",0,0,0,0
"1998 Winter","Moldova",0,0,0,0
"1998 Winter","Poland",0,0,0,0
"1998 Winter","Serbia",0,0,0,0
"1998 Winter","Virgin Islands, US",0,0,0,0
"1998 Winter","Slovakia",0,0,0,0
"1998 Winter","Hungary",0,0,0,0
"1998 Winter","Lithuania",0,0,0,0
"1998 Winter","Brazil",0,0,0,0
"1998 Winter","Spain",0,0,0,0
"1998 Winter","Slovenia",0,0,0,0
"1998 Winter","Armenia",0,0,0,0
"1998 Winter","Uzbekistan",0,0,0,0
"1998 Winter","Puerto Rico",0,0,0,0
"1998 Winter","South Africa",0,0,0,0
"2000 Summer","USA",130,61,51,242
"2000 Summer","Russia",66,67,54,187
"2000 Summer","Australia",60,69,54,183
"2000 Summer","Germany",31,23,64,118
"2000 Summer","China",39,23,17,79
"2000 Summer","Netherlands",27,29,23,79
"2000 Summer","South Korea",12,26,35,73
"2000 Summer","France",22,30,14,66
"2000 Summer","Italy",22,14,29,65
"2000 Summer","Cuba",18,35,12,65
"2000 Summer","UK",22,20,12,54
"2000 Summer","Hungary",25,24,4,53
"2000 Summer","Brazil",0,12,36,48
"2000 Summer","Romania",27,6,13,46
"2000 Summer","Japan",5,31,8,44
"2000 Summer","Norway",20,4,19,43
"2000 Summer","Spain",3,19,20,42
"2000 Summer","Ukraine",3,20,12,35
"2000 Summer","Sweden",4,20,8,32
"2000 Summer","Canada",4,4,23,31
"2000 Summer","Denmark",18,3,4,25
"2000 Summer","Serbia",11,1,13,25
"2000 Summer","Poland",7,10,7,24
"2000 Summer","Jamaica",0,20,3,23
"2000 Summer","Belarus",3,8,11,22
"2000 Summer","Argentina",0,17,3,20
"2000 Summer","Cameroon",18,0,0,18
"2000 Summer","Greece",4,6,8,18
"2000 Summer","Lithuania",2,0,15,17
"2000 Summer","Chile",0,0,17,17
"2000 Summer","Switzerland",1,11,2,14
"2000 Summer","Bulgaria",5,6,2,13
"2000 Summer","Bahamas",6,0,5,11
"2000 Summer","Croatia",1,0,9,10
"2000 Summer","Czech Republic",2,3,4,9
"2000 Summer","Nigeria",6,2,0,8
"2000 Summer","Ethiopia",4,1,3,8
"2000 Summer","Indonesia",2,4,2,8
"2000 Summer","Kazakhstan",3,4,0,7
"2000 Summer","Kenya",2,3,2,7
"2000 Summer","Belgium",0,3,4,7
"2000 Summer","Slovakia",2,3,1,6
"2000 Summer","Mexico",1,2,3,6
"2000 Summer","Georgia",0,0,6,6
"2000 Summer","Finland",3,1,1,5
"2000 Summer","Turkey",3,0,2,5
"2000 Summer","Algeria",1,1,3,5
"2000 Summer","South Africa",0,2,3,5
"2000 Summer","Taiwan",0,1,4,5
"2000 Summer","Morocco",0,1,4,5
"2000 Summer","Austria",3,1,0,4
"2000 Summer","Iran",3,0,1,4
"2000 Summer","Uzbekistan",1,1,2,4
"2000 Summer","New Zealand",1,0,3,4
"2000 Summer","North Korea",0,1,3,4
"2000 Summer","Slovenia",3,0,0,3
"2000 Summer","Azerbaijan",2,0,1,3
"2000 Summer","Latvia",1,1,1,3
"2000 Summer","Thailand",1,0,2,3
"2000 Summer","Estonia",1,0,2,3
"2000 Summer","Trinidad",0,1,1,2
"2000 Summer","Moldova",0,1,1,2
"2000 Summer","Saudi Arabia",0,1,1,2
"2000 Summer","Costa Rica",0,0,2,2
"2000 Summer","Portugal",0,0,2,2
"2000 Summer","Mozambique",1,0,0,1
"2000 Summer","Colombia",1,0,0,1
"2000 Summer","Ireland",0,1,0,1
"2000 Summer","Sri Lanka",0,1,0,1
"2000 Summer","Vietnam",0,1,0,1
"2000 Summer","Uruguay",0,1,0,1
"2000 Summer","Kyrgyzstan",0,0,1,1
"2000 Summer","Iceland",0,0,1,1
"2000 Summer","Israel",0,0,1,1
"2000 Summer","Macedonia",0,0,1,1
"2000 Summer","Armenia",0,0,1,1
"2000 Summer","Qatar",0,0,1,1
"2000 Summer","Barbados",0,0,1,1
"2000 Summer","Kuwait",0,0,1,1
"2000 Summer","India",0,0,1,1
"2000 Summer","Mauritania",0,0,0,0
"2000 Summer","Djibouti",0,0,0,0
"2000 Summer","Tunisia",0,0,0,0
"2000 Summer","Swaziland",0,0,0,0
"2000 Summer","Curacao",0,0,0,0
"2000 Summer","Maldives",0,0,0,0
"2000 Summer","Senegal",0,0,0,0
"2000 Summer","Saint Kitts",0,0,0,0
"2000 Summer","Monaco",0,0,0,0
"2000 Summer","Myanmar",0,0,0,0
"2000 Summer","Nicaragua",0,0,0,0
"2000 Summer","Dominican Republic",0,0,0,0
"2000 Summer","Burundi",0,0,0,0
"2000 Summer","Equatorial Guinea",0,0,0,0
"2000 Summer","Belize",0,0,0,0
"2000 Summer","Micronesia",0,0,0,0
"2000 Summer","Sudan",0,0,0,0
"2000 Summer","Ghana",0,0,0,0
"2000 Summer","Bhutan",0,0,0,0
"2000 Summer","Tanzania",0,0,0,0
"2000 Summer","Togo",0,0,0,0
"2000 Summer","Saint Lucia",0,0,0,0
"2000 Summer","Guinea-Bissau",0,0,0,0
"2000 Summer","Liberia",0,0,0,0
"2000 Summer","El Salvador",0,0,0,0
"2000 Summer","Cayman Islands",0,0,0,0
"2000 Summer","Luxembourg",0,0,0,0
"2000 Summer","Solomon Islands",0,0,0,0
"2000 Summer","Bosnia and Herzegovina",0,0,0,0
"2000 Summer","Grenada",0,0,0,0
"2000 Summer","Comoros",0,0,0,0
"2000 Summer","Virgin Islands, British",0,0,0,0
"2000 Summer","Bangladesh",0,0,0,0
"2000 Summer","Guyana",0,0,0,0
"2000 Summer","Seychelles",0,0,0,0
"2000 Summer","Mauritius",0,0,0,0
"2000 Summer","Malta",0,0,0,0
"2000 Summer","Chad",0,0,0,0
"2000 Summer","Burkina Faso",0,0,0,0
"2000 Summer","Aruba",0,0,0,0
"2000 Summer","Philippines",0,0,0,0
"2000 Summer","Cyprus",0,0,0,0
"2000 Summer","Puerto Rico",0,0,0,0
"2000 Summer","Zambia",0,0,0,0
"2000 Summer","San Marino",0,0,0,0
"2000 Summer","Mongolia",0,0,0,0
"2000 Summer","Botswana",0,0,0,0
"2000 Summer","Antigua",0,0,0,0
"2000 Summer","Ecuador",0,0,0,0
"2000 Summer","Laos",0,0,0,0
"2000 Summer","Namibia",0,0,0,0
"2000 Summer","Samoa",0,0,0,0
"2000 Summer","Malaysia",0,0,0,0
"2000 Summer","Dominica",0,0,0,0
"2000 Summer","Eritrea",0,0,0,0
"2000 Summer","Turkmenistan",0,0,0,0
"2000 Summer","Boliva",0,0,0,0
"2000 Summer","Haiti",0,0,0,0
"2000 Summer","Cook Islands",0,0,0,0
"2000 Summer","Angola",0,0,0,0
"2000 Summer","Zimbabwe",0,0,0,0
"2000 Summer","Malawi",0,0,0,0
"2000 Summer","Virgin Islands, US",0,0,0,0
"2000 Summer","Fiji",0,0,0,0
"2000 Summer","Uganda",0,0,0,0
"2000 Summer","Sao Tome and Principe",0,0,0,0
"2000 Summer","Lebanon",0,0,0,0
"2000 Summer","Panama",0,0,0,0
"2000 Summer","Sierra Leone",0,0,0,0
"2000 Summer","Bahrain",0,0,0,0
"2000 Summer","Central African Republic",0,0,0,0
"2000 Summer","Liechtenstein",0,0,0,0
"2000 Summer","Tonga",0,0,0,0
"2000 Summer","Saint Vincent",0,0,0,0
"2000 Summer","Bermuda",0,0,0,0
"2000 Summer","Honduras",0,0,0,0
"2000 Summer","Somalia",0,0,0,0
"2000 Summer","Guam",0,0,0,0
"2000 Summer","Benin",0,0,0,0
"2000 Summer","Individual Olympic Athletes",0,0,0,0
"2000 Summer","Tajikistan",0,0,0,0
"2000 Summer","Albania",0,0,0,0
"2000 Summer","Democratic Republic of the Congo",0,0,0,0
"2000 Summer","Egypt",0,0,0,0
"2000 Summer","Gabon",0,0,0,0
"2000 Summer","American Samoa",0,0,0,0
"2000 Summer","Syria",0,0,0,0
"2000 Summer","Iraq",0,0,0,0
"2000 Summer","Papua New Guinea",0,0,0,0
"2000 Summer","United Arab Emirates",0,0,0,0
"2000 Summer","Guinea",0,0,0,0
"2000 Summer","Guatemala",0,0,0,0
"2000 Summer","Cambodia",0,0,0,0
"2000 Summer","Nepal",0,0,0,0
"2000 Summer","Mali",0,0,0,0
"2000 Summer","Palau",0,0,0,0
"2000 Summer","Peru",0,0,0,0
"2000 Summer","Gambia",0,0,0,0
"2000 Summer","Venezuela",0,0,0,0
"2000 Summer","Jordan",0,0,0,0
"2000 Summer","Niger",0,0,0,0
"2000 Summer","Pakistan",0,0,0,0
"2000 Summer","Libya",0,0,0,0
"2000 Summer","Nauru",0,0,0,0
"2000 Summer","Suriname",0,0,0,0
"2000 Summer","Lesotho",0,0,0,0
"2000 Summer","Brunei",0,0,0,0
"2000 Summer","Paraguay",0,0,0,0
"2000 Summer","Ivory Coast",0,0,0,0
"2000 Summer","Cape Verde",0,0,0,0
"2000 Summer","Madagascar",0,0,0,0
"2000 Summer","Republic of Congo",0,0,0,0
"2000 Summer","Andorra",0,0,0,0
"2000 Summer","Yemen",0,0,0,0
"2000 Summer","Rwanda",0,0,0,0
"2000 Summer","Vanuatu",0,0,0,0
"2000 Summer","Oman",0,0,0,0
"2000 Summer","Palestine",0,0,0,0
"2002 Winter","USA",11,58,15,84
"2002 Winter","Canada",52,7,15,74
"2002 Winter","Germany",26,23,12,61
"2002 Winter","Norway",23,11,7,41
"2002 Winter","Russia",6,5,27,38
"2002 Winter","Sweden",0,2,24,26
"2002 Winter","Switzerland",3,7,14,24
"2002 Winter","Italy",4,11,6,21
"2002 Winter","Austria",3,4,13,20
"2002 Winter","China",2,5,9,16
"2002 Winter","France",5,5,5,15
"2002 Winter","Finland",7,5,1,13
"2002 Winter","Netherlands",3,5,0,8
"2002 Winter","South Korea",5,2,0,7
"2002 Winter","UK",5,0,1,6
"2002 Winter","Croatia",3,1,0,4
"2002 Winter","Slovenia",0,0,4,4
"2002 Winter","Czech Republic",1,2,0,3
"2002 Winter","Estonia",1,1,1,3
"2002 Winter","Bulgaria",0,1,2,3
"2002 Winter","Australia",2,0,0,2
"2002 Winter","Poland",0,1,1,2
"2002 Winter","Japan",0,1,1,2
"2002 Winter","Belarus",0,0,1,1
"2002 Winter","Turkey",0,0,0,0
"2002 Winter","South Africa",0,0,0,0
"2002 Winter","Cyprus",0,0,0,0
"2002 Winter","Trinidad",0,0,0,0
"2002 Winter","Kyrgyzstan",0,0,0,0
"2002 Winter","Azerbaijan",0,0,0,0
"2002 Winter","Nepal",0,0,0,0
"2002 Winter","Ireland",0,0,0,0
"2002 Winter","Iran",0,0,0,0
"2002 Winter","Moldova",0,0,0,0
"2002 Winter","Virgin Islands, US",0,0,0,0
"2002 Winter","Latvia",0,0,0,0
"2002 Winter","Andorra",0,0,0,0
"2002 Winter","Bermuda",0,0,0,0
"2002 Winter","Taiwan",0,0,0,0
"2002 Winter","Romania",0,0,0,0
"2002 Winter","Bosnia and Herzegovina",0,0,0,0
"2002 Winter","Armenia",0,0,0,0
"2002 Winter","Monaco",0,0,0,0
"2002 Winter","Macedonia",0,0,0,0
"2002 Winter","Venezuela",0,0,0,0
"2002 Winter","Cameroon",0,0,0,0
"2002 Winter","Denmark",0,0,0,0
"2002 Winter","Mongolia",0,0,0,0
"2002 Winter","San Marino",0,0,0,0
"2002 Winter","Kazakhstan",0,0,0,0
"2002 Winter","Georgia",0,0,0,0
"2002 Winter","Mexico",0,0,0,0
"2002 Winter","Lithuania",0,0,0,0
"2002 Winter","Tajikistan",0,0,0,0
"2002 Winter","Greece",0,0,0,0
"2002 Winter","Fiji",0,0,0,0
"2002 Winter","Costa Rica",0,0,0,0
"2002 Winter","New Zealand",0,0,0,0
"2002 Winter","Chile",0,0,0,0
"2002 Winter","Lebanon",0,0,0,0
"2002 Winter","Israel",0,0,0,0
"2002 Winter","Brazil",0,0,0,0
"2002 Winter","Slovakia",0,0,0,0
"2002 Winter","Thailand",0,0,0,0
"2002 Winter","Serbia",0,0,0,0
"2002 Winter","Argentina",0,0,0,0
"2002 Winter","Spain",0,0,0,0
"2002 Winter","Kenya",0,0,0,0
"2002 Winter","Hungary",0,0,0,0
"2002 Winter","Iceland",0,0,0,0
"2002 Winter","Belgium",0,0,0,0
"2002 Winter","India",0,0,0,0
"2002 Winter","Jamaica",0,0,0,0
"2002 Winter","Liechtenstein",0,0,0,0
"2002 Winter","Uzbekistan",0,0,0,0
"2002 Winter","Ukraine",0,0,0,0
"2004 Summer","USA",117,75,71,263
"2004 Summer","Russia",48,46,95,189
"2004 Summer","Australia",49,77,31,157
"2004 Summer","Germany",41,45,63,149
"2004 Summer","Italy",24,41,39,104
"2004 Summer","China",52,29,15,96
"2004 Summer","Japan",21,20,52,93
"2004 Summer","Netherlands",4,51,22,77
"2004 Summer","Cuba",32,8,22,62
"2004 Summer","UK",17,25,15,57
"2004 Summer","France",21,10,22,53
"2004 Summer","South Korea",14,28,10,52
"2004 Summer","Argentina",28,0,21,49
"2004 Summer","Ukraine",8,8,31,47
"2004 Summer","Hungary",24,12,4,40
"2004 Summer","Brazil",18,19,3,40
"2004 Summer","Romania",23,5,11,39
"2004 Summer","Greece",8,18,5,31
"2004 Summer","Spain",4,17,9,30
"2004 Summer","Denmark",19,1,9,29
"2004 Summer","Croatia",15,3,3,21
"2004 Summer","Canada",3,10,4,17
"2004 Summer","Bulgaria",2,1,14,17
"2004 Summer","Paraguay",0,17,0,17
"2004 Summer","Belarus",2,5,8,15
"2004 Summer","Jamaica",6,1,6,13
"2004 Summer","Czech Republic",1,6,6,13
"2004 Summer","Serbia",0,13,0,13
"2004 Summer","Sweden",5,5,2,12
"2004 Summer","Poland",4,2,6,12
"2004 Summer","Turkey",3,3,5,11
"2004 Summer","South Africa",4,3,3,10
"2004 Summer","Slovakia",3,2,5,10
"2004 Summer","Taiwan",2,4,3,9
"2004 Summer","Austria",3,4,1,8
"2004 Summer","Thailand",3,1,4,8
"2004 Summer","Kazakhstan",1,4,3,8
"2004 Summer","Nigeria",0,0,8,8
"2004 Summer","Norway",5,0,2,7
"2004 Summer","Ethiopia",2,3,2,7
"2004 Summer","Kenya",1,4,2,7
"2004 Summer","Switzerland",1,2,4,7
"2004 Summer","New Zealand",4,2,0,6
"2004 Summer","Iran",2,2,2,6
"2004 Summer","Uzbekistan",2,1,2,5
"2004 Summer","Indonesia",1,1,3,5
"2004 Summer","Egypt",1,1,3,5
"2004 Summer","Azerbaijan",1,0,4,5
"2004 Summer","North Korea",0,4,1,5
"2004 Summer","Slovenia",0,2,3,5
"2004 Summer","Chile",3,0,1,4
"2004 Summer","Georgia",2,2,0,4
"2004 Summer","Latvia",0,4,0,4
"2004 Summer","Mexico",0,3,1,4
"2004 Summer","Morocco",2,1,0,3
"2004 Summer","Lithuania",1,2,0,3
"2004 Summer","Zimbabwe",1,1,1,3
"2004 Summer","Belgium",1,0,2,3
"2004 Summer","Portugal",0,2,1,3
"2004 Summer","Estonia",0,1,2,3
"2004 Summer","Bahamas",1,0,1,2
"2004 Summer","Israel",1,0,1,2
"2004 Summer","Finland",0,2,0,2
"2004 Summer","Venezuela",0,0,2,2
"2004 Summer","Colombia",0,0,2,2
"2004 Summer","Cameroon",1,0,0,1
"2004 Summer","United Arab Emirates",1,0,0,1
"2004 Summer","Dominican Republic",1,0,0,1
"2004 Summer","India",0,1,0,1
"2004 Summer","Mongolia",0,0,1,1
"2004 Summer","Eritrea",0,0,1,1
"2004 Summer","Syria",0,0,1,1
"2004 Summer","Trinidad",0,0,1,1
"2004 Summer","Bangladesh",0,0,0,0
"2004 Summer","Sierra Leone",0,0,0,0
"2004 Summer","Zambia",0,0,0,0
"2004 Summer","Luxembourg",0,0,0,0
"2004 Summer","Tonga",0,0,0,0
"2004 Summer","Seychelles",0,0,0,0
"2004 Summer","Tanzania",0,0,0,0
"2004 Summer","Republic of Congo",0,0,0,0
"2004 Summer","Angola",0,0,0,0
"2004 Summer","Kyrgyzstan",0,0,0,0
"2004 Summer","Swaziland",0,0,0,0
"2004 Summer","Madagascar",0,0,0,0
"2004 Summer","San Marino",0,0,0,0
"2004 Summer","Grenada",0,0,0,0
"2004 Summer","Malawi",0,0,0,0
"2004 Summer","Guam",0,0,0,0
"2004 Summer","Boliva",0,0,0,0
"2004 Summer","El Salvador",0,0,0,0
"2004 Summer","Burkina Faso",0,0,0,0
"2004 Summer","Vietnam",0,0,0,0
"2004 Summer","Malaysia",0,0,0,0
"2004 Summer","Brunei",0,0,0,0
"2004 Summer","Papua New Guinea",0,0,0,0
"2004 Summer","Panama",0,0,0,0
"2004 Summer","Armenia",0,0,0,0
"2004 Summer","Tunisia",0,0,0,0
"2004 Summer","Andorra",0,0,0,0
"2004 Summer","Haiti",0,0,0,0
"2004 Summer","Burundi",0,0,0,0
"2004 Summer","Mauritania",0,0,0,0
"2004 Summer","Benin",0,0,0,0
"2004 Summer","American Samoa",0,0,0,0
"2004 Summer","Namibia",0,0,0,0
"2004 Summer","Cayman Islands",0,0,0,0
"2004 Summer","Yemen",0,0,0,0
"2004 Summer","Bahrain",0,0,0,0
"2004 Summer","Kiribati",0,0,0,0
"2004 Summer","Iceland",0,0,0,0
"2004 Summer","Guinea-Bissau",0,0,0,0
"2004 Summer","Liechtenstein",0,0,0,0
"2004 Summer","Mauritius",0,0,0,0
"2004 Summer","Solomon Islands",0,0,0,0
"2004 Summer","Maldives",0,0,0,0
"2004 Summer","Uruguay",0,0,0,0
"2004 Summer","Algeria",0,0,0,0
"2004 Summer","Iraq",0,0,0,0
"2004 Summer","Mozambique",0,0,0,0
"2004 Summer","Albania",0,0,0,0
"2004 Summer","Botswana",0,0,0,0
"2004 Summer","Jordan",0,0,0,0
"2004 Summer","Philippines",0,0,0,0
"2004 Summer","Saint Vincent",0,0,0,0
"2004 Summer","Suriname",0,0,0,0
"2004 Summer","Comoros",0,0,0,0
"2004 Summer","Lesotho",0,0,0,0
"2004 Summer","Equatorial Guinea",0,0,0,0
"2004 Summer","Bhutan",0,0,0,0
"2004 Summer","Sudan",0,0,0,0
"2004 Summer","Bosnia and Herzegovina",0,0,0,0
"2004 Summer","Sao Tome and Principe",0,0,0,0
"2004 Summer","Saint Lucia",0,0,0,0
"2004 Summer","Palau",0,0,0,0
"2004 Summer","Belize",0,0,0,0
"2004 Summer","Turkmenistan",0,0,0,0
"2004 Summer","Monaco",0,0,0,0
"2004 Summer","Gambia",0,0,0,0
"2004 Summer","Virgin Islands, British",0,0,0,0
"2004 Summer","Sri Lanka",0,0,0,0
"2004 Summer","Saint Kitts",0,0,0,0
"2004 Summer","Nepal",0,0,0,0
"2004 Summer","Uganda",0,0,0,0
"2004 Summer","Ivory Coast",0,0,0,0
"2004 Summer","Guatemala",0,0,0,0
"2004 Summer","Lebanon",0,0,0,0
"2004 Summer","Guinea",0,0,0,0
"2004 Summer","Chad",0,0,0,0
"2004 Summer","Libya",0,0,0,0
"2004 Summer","Democratic Republic of the Congo",0,0,0,0
"2004 Summer","Curacao",0,0,0,0
"2004 Summer","Timor-Leste",0,0,0,0
"2004 Summer","Myanmar",0,0,0,0
"2004 Summer","Tajikistan",0,0,0,0
"2004 Summer","Central African Republic",0,0,0,0
"2004 Summer","Qatar",0,0,0,0
"2004 Summer","Somalia",0,0,0,0
"2004 Summer","Bermuda",0,0,0,0
"2004 Summer","Cook Islands",0,0,0,0
"2004 Summer","Fiji",0,0,0,0
"2004 Summer","Macedonia",0,0,0,0
"2004 Summer","Samoa",0,0,0,0
"2004 Summer","Senegal",0,0,0,0
"2004 Summer","Kuwait",0,0,0,0
"2004 Summer","Togo",0,0,0,0
"2004 Summer","Ecuador",0,0,0,0
"2004 Summer","Niger",0,0,0,0
"2004 Summer","Laos",0,0,0,0
"2004 Summer","Gabon",0,0,0,0
"2004 Summer","Aruba",0,0,0,0
"2004 Summer","Nicaragua",0,0,0,0
"2004 Summer","Guyana",0,0,0,0
"2004 Summer","Mali",0,0,0,0
"2004 Summer","Palestine",0,0,0,0
"2004 Summer","Oman",0,0,0,0
"2004 Summer","Cambodia",0,0,0,0
"2004 Summer","Pakistan",0,0,0,0
"2004 Summer","Afghanistan",0,0,0,0
"2004 Summer","Nauru",0,0,0,0
"2004 Summer","Rwanda",0,0,0,0
"2004 Summer","Dominica",0,0,0,0
"2004 Summer","Honduras",0,0,0,0
"2004 Summer","Moldova",0,0,0,0
"2004 Summer","Cape Verde",0,0,0,0
"2004 Summer","Saudi Arabia",0,0,0,0
"2004 Summer","Virgin Islands, US",0,0,0,0
"2004 Summer","Malta",0,0,0,0
"2004 Summer","Micronesia",0,0,0,0
"2004 Summer","Barbados",0,0,0,0
"2004 Summer","Cyprus",0,0,0,0
"2004 Summer","Costa Rica",0,0,0,0
"2004 Summer","Puerto Rico",0,0,0,0
"2004 Summer","Vanuatu",0,0,0,0
"2004 Summer","Liberia",0,0,0,0
"2004 Summer","Ireland",0,0,0,0
"2004 Summer","Ghana",0,0,0,0
"2004 Summer","Peru",0,0,0,0
"2004 Summer","Antigua",0,0,0,0
"2006 Winter","Canada",30,28,11,69
"2006 Winter","Sweden",35,21,8,64
"2006 Winter","Germany",23,25,6,54
"2006 Winter","USA",9,11,32,52
"2006 Winter","Russia",16,12,13,41
"2006 Winter","Finland",0,34,7,41
"2006 Winter","Austria",16,7,7,30
"2006 Winter","Czech Republic",1,2,24,27
"2006 Winter","Italy",11,0,14,25
"2006 Winter","Norway",2,9,12,23
"2006 Winter","Switzerland",5,7,9,21
"2006 Winter","South Korea",14,3,2,19
"2006 Winter","France",3,2,10,15
"2006 Winter","Netherlands",3,2,8,13
"2006 Winter","China",2,5,6,13
"2006 Winter","Estonia",3,0,0,3
"2006 Winter","Croatia",1,2,0,3
"2006 Winter","Ukraine",0,0,3,3
"2006 Winter","Australia",1,0,1,2
"2006 Winter","Poland",0,1,1,2
"2006 Winter","Japan",1,0,0,1
"2006 Winter","Bulgaria",0,1,0,1
"2006 Winter","UK",0,1,0,1
"2006 Winter","Slovakia",0,1,0,1
"2006 Winter","Belarus",0,1,0,1
"2006 Winter","Latvia",0,0,1,1
"2006 Winter","Chile",0,0,0,0
"2006 Winter","Senegal",0,0,0,0
"2006 Winter","Portugal",0,0,0,0
"2006 Winter","Monaco",0,0,0,0
"2006 Winter","Moldova",0,0,0,0
"2006 Winter","Nepal",0,0,0,0
"2006 Winter","North Korea",0,0,0,0
"2006 Winter","Kazakhstan",0,0,0,0
"2006 Winter","South Africa",0,0,0,0
"2006 Winter","Azerbaijan",0,0,0,0
"2006 Winter","Serbia",0,0,0,0
"2006 Winter","Armenia",0,0,0,0
"2006 Winter","Bosnia and Herzegovina",0,0,0,0
"2006 Winter","Spain",0,0,0,0
"2006 Winter","Kyrgyzstan",0,0,0,0
"2006 Winter","San Marino",0,0,0,0
"2006 Winter","Taiwan",0,0,0,0
"2006 Winter","Denmark",0,0,0,0
"2006 Winter","Andorra",0,0,0,0
"2006 Winter","Madagascar",0,0,0,0
"2006 Winter","Liechtenstein",0,0,0,0
"2006 Winter","Hungary",0,0,0,0
"2006 Winter","Cyprus",0,0,0,0
"2006 Winter","Algeria",0,0,0,0
"2006 Winter","Uzbekistan",0,0,0,0
"2006 Winter","Ethiopia",0,0,0,0
"2006 Winter","Israel",0,0,0,0
"2006 Winter","Mongolia",0,0,0,0
"2006 Winter","Belgium",0,0,0,0
"2006 Winter","Venezuela",0,0,0,0
"2006 Winter","Macedonia",0,0,0,0
"2006 Winter","Thailand",0,0,0,0
"2006 Winter","Tajikistan",0,0,0,0
"2006 Winter","Georgia",0,0,0,0
"2006 Winter","Costa Rica",0,0,0,0
"2006 Winter","Bermuda",0,0,0,0
"2006 Winter","Lebanon",0,0,0,0
"2006 Winter","Kenya",0,0,0,0
"2006 Winter","Greece",0,0,0,0
"2006 Winter","Turkey",0,0,0,0
"2006 Winter","Iceland",0,0,0,0
"2006 Winter","Lithuania",0,0,0,0
"2006 Winter","India",0,0,0,0
"2006 Winter","Romania",0,0,0,0
"2006 Winter","New Zealand",0,0,0,0
"2006 Winter","Slovenia",0,0,0,0
"2006 Winter","Iran",0,0,0,0
"2006 Winter","Albania",0,0,0,0
"2006 Winter","Luxembourg",0,0,0,0
"2006 Winter","Ireland",0,0,0,0
"2006 Winter","Argentina",0,0,0,0
"2006 Winter","Brazil",0,0,0,0
"2008 Summer","USA",127,110,80,317
"2008 Summer","China",74,53,57,184
"2008 Summer","Australia",31,42,76,149
"2008 Summer","Russia",43,46,53,142
"2008 Summer","Germany",42,16,41,99
"2008 Summer","UK",31,25,25,81
"2008 Summer","South Korea",41,11,26,78
"2008 Summer","Brazil",14,34,30,78
"2008 Summer","France",25,24,28,77
"2008 Summer","Spain",7,47,16,70
"2008 Summer","Netherlands",39,18,4,61
"2008 Summer","Japan",23,15,13,51
"2008 Summer","Argentina",20,0,31,51
"2008 Summer","Cuba",2,34,11,47
"2008 Summer","Italy",8,14,20,42
"2008 Summer","Canada",11,13,11,35
"2008 Summer","Ukraine",10,5,16,31
"2008 Summer","Belarus",8,5,16,29
"2008 Summer","Hungary",16,8,3,27
"2008 Summer","Nigeria",0,16,7,23
"2008 Summer","Norway",16,5,1,22
"2008 Summer","Romania",5,1,16,22
"2008 Summer","Poland",6,13,1,20
"2008 Summer","Denmark",6,7,6,19
"2008 Summer","Kenya",6,4,5,15
"2008 Summer","New Zealand",4,2,9,15
"2008 Summer","Serbia",0,1,14,15
"2008 Summer","Jamaica",5,3,6,14
"2008 Summer","Iceland",0,14,0,14
"2008 Summer","Kazakhstan",2,4,7,13
"2008 Summer","Switzerland",3,1,7,11
"2008 Summer","Slovakia",4,5,1,10
"2008 Summer","Ethiopia",4,1,2,7
"2008 Summer","Czech Republic",3,4,0,7
"2008 Summer","Indonesia",2,2,3,7
"2008 Summer","Turkey",1,3,3,7
"2008 Summer","Azerbaijan",1,2,4,7
"2008 Summer","Bahamas",0,6,1,7
"2008 Summer","Sweden",0,5,2,7
"2008 Summer","Greece",0,3,4,7
"2008 Summer","Trinidad",5,1,0,6
"2008 Summer","Georgia",3,0,3,6
"2008 Summer","North Korea",2,1,3,6
"2008 Summer","Uzbekistan",1,2,3,6
"2008 Summer","Armenia",0,0,6,6
"2008 Summer","Belgium",1,4,0,5
"2008 Summer","Finland",1,2,2,5
"2008 Summer","Slovenia",1,2,2,5
"2008 Summer","Bulgaria",1,1,3,5
"2008 Summer","Croatia",0,2,3,5
"2008 Summer","Lithuania",0,2,3,5
"2008 Summer","Thailand",2,2,0,4
"2008 Summer","Mongolia",2,2,0,4
"2008 Summer","Mexico",2,0,2,4
"2008 Summer","Zimbabwe",1,3,0,4
"2008 Summer","Taiwan",0,0,4,4
"2008 Summer","Estonia",1,2,0,3
"2008 Summer","Latvia",1,1,1,3
"2008 Summer","India",1,0,2,3
"2008 Summer","Austria",0,1,2,3
"2008 Summer","Ireland",0,1,2,3
"2008 Summer","Dominican Republic",1,1,0,2
"2008 Summer","Portugal",1,1,0,2
"2008 Summer","Iran",1,0,1,2
"2008 Summer","Tajikistan",0,1,1,2
"2008 Summer","Morocco",0,1,1,2
"2008 Summer","Kyrgyzstan",0,1,1,2
"2008 Summer","Algeria",0,1,1,2
"2008 Summer","Colombia",0,1,1,2
"2008 Summer","Panama",1,0,0,1
"2008 Summer","Cameroon",1,0,0,1
"2008 Summer","Tunisia",1,0,0,1
"2008 Summer","Vietnam",0,1,0,1
"2008 Summer","Chile",0,1,0,1
"2008 Summer","Malaysia",0,1,0,1
"2008 Summer","Sudan",0,1,0,1
"2008 Summer","South Africa",0,1,0,1
"2008 Summer","Ecuador",0,1,0,1
"2008 Summer","Mauritius",0,0,1,1
"2008 Summer","Israel",0,0,1,1
"2008 Summer","Egypt",0,0,1,1
"2008 Summer","Moldova",0,0,1,1
"2008 Summer","Venezuela",0,0,1,1
"2008 Summer","Togo",0,0,1,1
"2008 Summer","Afghanistan",0,0,1,1
"2008 Summer","Bhutan",0,0,0,0
"2008 Summer","Equatorial Guinea",0,0,0,0
"2008 Summer","Solomon Islands",0,0,0,0
"2008 Summer","Suriname",0,0,0,0
"2008 Summer","Papua New Guinea",0,0,0,0
"2008 Summer","Vanuatu",0,0,0,0
"2008 Summer","Haiti",0,0,0,0
"2008 Summer","Montenegro",0,0,0,0
"2008 Summer","Nepal",0,0,0,0
"2008 Summer","Albania",0,0,0,0
"2008 Summer","Guatemala",0,0,0,0
"2008 Summer","Guinea",0,0,0,0
"2008 Summer","Andorra",0,0,0,0
"2008 Summer","Somalia",0,0,0,0
"2008 Summer","Madagascar",0,0,0,0
"2008 Summer","El Salvador",0,0,0,0
"2008 Summer","Aruba",0,0,0,0
"2008 Summer","Kuwait",0,0,0,0
"2008 Summer","Tonga",0,0,0,0
"2008 Summer","Yemen",0,0,0,0
"2008 Summer","Ghana",0,0,0,0
"2008 Summer","American Samoa",0,0,0,0
"2008 Summer","Zambia",0,0,0,0
"2008 Summer","Boliva",0,0,0,0
"2008 Summer","Guyana",0,0,0,0
"2008 Summer","Malawi",0,0,0,0
"2008 Summer","Namibia",0,0,0,0
"2008 Summer","Rwanda",0,0,0,0
"2008 Summer","Nicaragua",0,0,0,0
"2008 Summer","Tanzania",0,0,0,0
"2008 Summer","Benin",0,0,0,0
"2008 Summer","Djibouti",0,0,0,0
"2008 Summer","Republic of Congo",0,0,0,0
"2008 Summer","Saint Kitts",0,0,0,0
"2008 Summer","Libya",0,0,0,0
"2008 Summer","Virgin Islands, US",0,0,0,0
"2008 Summer","Palau",0,0,0,0
"2008 Summer","Guam",0,0,0,0
"2008 Summer","Comoros",0,0,0,0
"2008 Summer","Cayman Islands",0,0,0,0
"2008 Summer","Botswana",0,0,0,0
"2008 Summer","Liechtenstein",0,0,0,0
"2008 Summer","Burundi",0,0,0,0
"2008 Summer","Palestine",0,0,0,0
"2008 Summer","Belize",0,0,0,0
"2008 Summer","Qatar",0,0,0,0
"2008 Summer","Syria",0,0,0,0
"2008 Summer","Mali",0,0,0,0
"2008 Summer","Pakistan",0,0,0,0
"2008 Summer","Angola",0,0,0,0
"2008 Summer","United Arab Emirates",0,0,0,0
"2008 Summer","Uruguay",0,0,0,0
"2008 Summer","Cambodia",0,0,0,0
"2008 Summer","Saudi Arabia",0,0,0,0
"2008 Summer","Mauritania",0,0,0,0
"2008 Summer","Eritrea",0,0,0,0
"2008 Summer","Saint Vincent",0,0,0,0
"2008 Summer","Uganda",0,0,0,0
"2008 Summer","Peru",0,0,0,0
"2008 Summer","NA",0,0,0,0
"2008 Summer","Democratic Republic of the Congo",0,0,0,0
"2008 Summer","Bosnia and Herzegovina",0,0,0,0
"2008 Summer","Senegal",0,0,0,0
"2008 Summer","Micronesia",0,0,0,0
"2008 Summer","Sri Lanka",0,0,0,0
"2008 Summer","Niger",0,0,0,0
"2008 Summer","Sierra Leone",0,0,0,0
"2008 Summer","Lesotho",0,0,0,0
"2008 Summer","Gabon",0,0,0,0
"2008 Summer","Chad",0,0,0,0
"2008 Summer","Paraguay",0,0,0,0
"2008 Summer","Fiji",0,0,0,0
"2008 Summer","Seychelles",0,0,0,0
"2008 Summer","Curacao",0,0,0,0
"2008 Summer","Dominica",0,0,0,0
"2008 Summer","Kiribati",0,0,0,0
"2008 Summer","Cook Islands",0,0,0,0
"2008 Summer","Central African Republic",0,0,0,0
"2008 Summer","Nauru",0,0,0,0
"2008 Summer","Jordan",0,0,0,0
"2008 Summer","Oman",0,0,0,0
"2008 Summer","Myanmar",0,0,0,0
"2008 Summer","Luxembourg",0,0,0,0
"2008 Summer","Laos",0,0,0,0
"2008 Summer","Turkmenistan",0,0,0,0
"2008 Summer","San Marino",0,0,0,0
"2008 Summer","Gambia",0,0,0,0
"2008 Summer","Bermuda",0,0,0,0
"2008 Summer","Samoa",0,0,0,0
"2008 Summer","Costa Rica",0,0,0,0
"2008 Summer","Iraq",0,0,0,0
"2008 Summer","Antigua",0,0,0,0
"2008 Summer","Malta",0,0,0,0
"2008 Summer","Timor-Leste",0,0,0,0
"2008 Summer","Ivory Coast",0,0,0,0
"2008 Summer","Grenada",0,0,0,0
"2008 Summer","Liberia",0,0,0,0
"2008 Summer","Barbados",0,0,0,0
"2008 Summer","Saint Lucia",0,0,0,0
"2008 Summer","Bahrain",0,0,0,0
"2008 Summer","Burkina Faso",0,0,0,0
"2008 Summer","Cyprus",0,0,0,0
"2008 Summer","Honduras",0,0,0,0
"2008 Summer","Philippines",0,0,0,0
"2008 Summer","Puerto Rico",0,0,0,0
"2008 Summer","Virgin Islands, British",0,0,0,0
"2008 Summer","Bangladesh",0,0,0,0
"2008 Summer","Mozambique",0,0,0,0
"2008 Summer","Marshall Islands",0,0,0,0
"2008 Summer","Macedonia",0,0,0,0
"2008 Summer","Guinea-Bissau",0,0,0,0
"2008 Summer","Maldives",0,0,0,0
"2008 Summer","Sao Tome and Principe",0,0,0,0
"2008 Summer","Cape Verde",0,0,0,0
"2008 Summer","Swaziland",0,0,0,0
"2008 Summer","Monaco",0,0,0,0
"2008 Summer","Lebanon",0,0,0,0
"2010 Winter","USA",12,63,22,97
"2010 Winter","Canada",67,15,8,90
"2010 Winter","Germany",15,24,15,54
"2010 Winter","Finland",0,1,46,47
"2010 Winter","Norway",16,14,9,39
"2010 Winter","Austria",11,9,6,26
"2010 Winter","Russia",6,5,14,25
"2010 Winter","China",9,3,7,19
"2010 Winter","Sweden",11,3,4,18
"2010 Winter","South Korea",6,10,2,18
"2010 Winter","France",2,6,6,14
"2010 Winter","Switzerland",6,0,6,12
"2010 Winter","Netherlands",4,1,6,11
"2010 Winter","Czech Republic",2,0,7,9
"2010 Winter","Poland",1,3,4,8
"2010 Winter","Japan",0,5,2,7
"2010 Winter","Italy",1,1,3,5
"2010 Winter","Australia",2,1,0,3
"2010 Winter","Slovakia",1,1,1,3
"2010 Winter","Belarus",1,1,1,3
"2010 Winter","Latvia",0,3,0,3
"2010 Winter","Croatia",0,2,1,3
"2010 Winter","Slovenia",0,2,1,3
"2010 Winter","UK",1,0,0,1
"2010 Winter","Estonia",0,1,0,1
"2010 Winter","Kazakhstan",0,1,0,1
"2010 Winter","Greece",0,0,0,0
"2010 Winter","Colombia",0,0,0,0
"2010 Winter","Argentina",0,0,0,0
"2010 Winter","Pakistan",0,0,0,0
"2010 Winter","Jamaica",0,0,0,0
"2010 Winter","Ghana",0,0,0,0
"2010 Winter","Georgia",0,0,0,0
"2010 Winter","Spain",0,0,0,0
"2010 Winter","Monaco",0,0,0,0
"2010 Winter","Iceland",0,0,0,0
"2010 Winter","Brazil",0,0,0,0
"2010 Winter","Bosnia and Herzegovina",0,0,0,0
"2010 Winter","Israel",0,0,0,0
"2010 Winter","Armenia",0,0,0,0
"2010 Winter","Senegal",0,0,0,0
"2010 Winter","Portugal",0,0,0,0
"2010 Winter","Ireland",0,0,0,0
"2010 Winter","South Africa",0,0,0,0
"2010 Winter","Taiwan",0,0,0,0
"2010 Winter","Cyprus",0,0,0,0
"2010 Winter","North Korea",0,0,0,0
"2010 Winter","Uzbekistan",0,0,0,0
"2010 Winter","Ethiopia",0,0,0,0
"2010 Winter","Hungary",0,0,0,0
"2010 Winter","Mongolia",0,0,0,0
"2010 Winter","Cayman Islands",0,0,0,0
"2010 Winter","Lithuania",0,0,0,0
"2010 Winter","Serbia",0,0,0,0
"2010 Winter","Bermuda",0,0,0,0
"2010 Winter","Ukraine",0,0,0,0
"2010 Winter","Bulgaria",0,0,0,0
"2010 Winter","Kyrgyzstan",0,0,0,0
"2010 Winter","Macedonia",0,0,0,0
"2010 Winter","Romania",0,0,0,0
"2010 Winter","Andorra",0,0,0,0
"2010 Winter","Lebanon",0,0,0,0
"2010 Winter","India",0,0,0,0
"2010 Winter","Turkey",0,0,0,0
"2010 Winter","Belgium",0,0,0,0
"2010 Winter","Algeria",0,0,0,0
"2010 Winter","Iran",0,0,0,0
"2010 Winter","Denmark",0,0,0,0
"2010 Winter","Liechtenstein",0,0,0,0
"2010 Winter","Albania",0,0,0,0
"2010 Winter","San Marino",0,0,0,0
"2010 Winter","Nepal",0,0,0,0
"2010 Winter","Montenegro",0,0,0,0
"2010 Winter","Peru",0,0,0,0
"2010 Winter","Morocco",0,0,0,0
"2010 Winter","Azerbaijan",0,0,0,0
"2010 Winter","Chile",0,0,0,0
"2010 Winter","Moldova",0,0,0,0
"2010 Winter","Tajikistan",0,0,0,0
"2010 Winter","New Zealand",0,0,0,0
"2010 Winter","Mexico",0,0,0,0
"2012 Summer","USA",145,57,46,248
"2012 Summer","Russia",50,39,51,140
"2012 Summer","China",56,40,30,126
"2012 Summer","UK",48,30,48,126
"2012 Summer","Australia",18,37,59,114
"2012 Summer","Germany",45,27,22,94
"2012 Summer","Japan",7,44,33,84
"2012 Summer","France",30,30,22,82
"2012 Summer","Netherlands",21,29,19,69
"2012 Summer","Italy",16,22,30,68
"2012 Summer","Spain",5,33,25,63
"2012 Summer","South Korea",18,13,30,61
"2012 Summer","Brazil",14,34,11,59
"2012 Summer","Canada",1,21,33,55
"2012 Summer","Croatia",15,4,16,35
"2012 Summer","New Zealand",9,3,15,27
"2012 Summer","Hungary",12,8,6,26
"2012 Summer","Ukraine",9,5,12,26
"2012 Summer","Jamaica",8,9,8,25
"2012 Summer","Mexico",16,5,3,24
"2012 Summer","Belarus",3,12,8,23
"2012 Summer","Sweden",2,17,3,22
"2012 Summer","Argentina",1,15,3,19
"2012 Summer","Norway",15,1,1,17
"2012 Summer","Denmark",3,5,8,16
"2012 Summer","Romania",2,8,6,16
"2012 Summer","Serbia",1,1,14,16
"2012 Summer","Cuba",5,3,6,14
"2012 Summer","Czech Republic",4,4,6,14
"2012 Summer","Montenegro",0,14,0,14
"2012 Summer","Kazakhstan",7,1,5,13
"2012 Summer","Iran",4,5,3,12
"2012 Summer","Poland",2,2,8,12
"2012 Summer","Kenya",2,4,5,11
"2012 Summer","Azerbaijan",2,2,6,10
"2012 Summer","Trinidad",1,4,5,10
"2012 Summer","South Africa",6,2,1,9
"2012 Summer","Colombia",1,3,4,8
"2012 Summer","Ethiopia",3,1,3,7
"2012 Summer","Georgia",1,3,3,7
"2012 Summer","North Korea",4,0,2,6
"2012 Summer","India",0,2,4,6
"2012 Summer","Turkey",2,2,1,5
"2012 Summer","Lithuania",2,1,2,5
"2012 Summer","Ireland",1,1,3,5
"2012 Summer","Slovenia",1,1,3,5
"2012 Summer","Mongolia",0,2,3,5
"2012 Summer","Finland",0,1,4,5
"2012 Summer","Slovakia",0,1,4,5
"2012 Summer","Bahamas",4,0,0,4
"2012 Summer","Switzerland",2,2,0,4
"2012 Summer","Saudi Arabia",0,0,4,4
"2012 Summer","Tunisia",1,1,1,3
"2012 Summer","Latvia",1,0,2,3
"2012 Summer","Uzbekistan",1,0,2,3
"2012 Summer","Thailand",0,2,1,3
"2012 Summer","Belgium",0,1,2,3
"2012 Summer","Armenia",0,1,2,3
"2012 Summer","Greece",0,0,3,3
"2012 Summer","Dominican Republic",1,1,0,2
"2012 Summer","Portugal",0,2,0,2
"2012 Summer","Egypt",0,2,0,2
"2012 Summer","Taiwan",0,1,1,2
"2012 Summer","Puerto Rico",0,1,1,2
"2012 Summer","Bulgaria",0,1,1,2
"2012 Summer","Estonia",0,1,1,2
"2012 Summer","Malaysia",0,1,1,2
"2012 Summer","Indonesia",0,1,1,2
"2012 Summer","Qatar",0,0,2,2
"2012 Summer","Moldova",0,0,2,2
"2012 Summer","Algeria",1,0,0,1
"2012 Summer","Venezuela",1,0,0,1
"2012 Summer","Uganda",1,0,0,1
"2012 Summer","Grenada",1,0,0,1
"2012 Summer","Cyprus",0,1,0,1
"2012 Summer","Gabon",0,1,0,1
"2012 Summer","Guatemala",0,1,0,1
"2012 Summer","Botswana",0,1,0,1
"2012 Summer","Bahrain",0,0,1,1
"2012 Summer","Kuwait",0,0,1,1
"2012 Summer","Afghanistan",0,0,1,1
"2012 Summer","Tajikistan",0,0,1,1
"2012 Summer","Morocco",0,0,1,1
"2012 Summer","Philippines",0,0,0,0
"2012 Summer","Mauritius",0,0,0,0
"2012 Summer","NA",0,0,0,0
"2012 Summer","Chad",0,0,0,0
"2012 Summer","Panama",0,0,0,0
"2012 Summer","Mozambique",0,0,0,0
"2012 Summer","Burundi",0,0,0,0
"2012 Summer","Lesotho",0,0,0,0
"2012 Summer","Benin",0,0,0,0
"2012 Summer","Nicaragua",0,0,0,0
"2012 Summer","Vietnam",0,0,0,0
"2012 Summer","Nauru",0,0,0,0
"2012 Summer","Cayman Islands",0,0,0,0
"2012 Summer","Brunei",0,0,0,0
"2012 Summer","Individual Olympic Athletes",0,0,0,0
"2012 Summer","Tonga",0,0,0,0
"2012 Summer","Bangladesh",0,0,0,0
"2012 Summer","Cape Verde",0,0,0,0
"2012 Summer","Zimbabwe",0,0,0,0
"2012 Summer","Libya",0,0,0,0
"2012 Summer","United Arab Emirates",0,0,0,0
"2012 Summer","Ghana",0,0,0,0
"2012 Summer","Chile",0,0,0,0
"2012 Summer","Saint Lucia",0,0,0,0
"2012 Summer","Andorra",0,0,0,0
"2012 Summer","Sri Lanka",0,0,0,0
"2012 Summer","American Samoa",0,0,0,0
"2012 Summer","Cameroon",0,0,0,0
"2012 Summer","Syria",0,0,0,0
"2012 Summer","Aruba",0,0,0,0
"2012 Summer","Laos",0,0,0,0
"2012 Summer","Iceland",0,0,0,0
"2012 Summer","Tanzania",0,0,0,0
"2012 Summer","Solomon Islands",0,0,0,0
"2012 Summer","Paraguay",0,0,0,0
"2012 Summer","Central African Republic",0,0,0,0
"2012 Summer","Malta",0,0,0,0
"2012 Summer","Austria",0,0,0,0
"2012 Summer","Turkmenistan",0,0,0,0
"2012 Summer","Swaziland",0,0,0,0
"2012 Summer","Haiti",0,0,0,0
"2012 Summer","Honduras",0,0,0,0
"2012 Summer","Namibia",0,0,0,0
"2012 Summer","Maldives",0,0,0,0
"2012 Summer","Monaco",0,0,0,0
"2012 Summer","Nepal",0,0,0,0
"2012 Summer","Iraq",0,0,0,0
"2012 Summer","Zambia",0,0,0,0
"2012 Summer","Boliva",0,0,0,0
"2012 Summer","Senegal",0,0,0,0
"2012 Summer","Liberia",0,0,0,0
"2012 Summer","San Marino",0,0,0,0
"2012 Summer","Luxembourg",0,0,0,0
"2012 Summer","Gambia",0,0,0,0
"2012 Summer","Somalia",0,0,0,0
"2012 Summer","Niger",0,0,0,0
"2012 Summer","Bermuda",0,0,0,0
"2012 Summer","Malawi",0,0,0,0
"2012 Summer","Djibouti",0,0,0,0
"2012 Summer","Guinea",0,0,0,0
"2012 Summer","Bosnia and Herzegovina",0,0,0,0
"2012 Summer","Saint Vincent",0,0,0,0
"2012 Summer","Costa Rica",0,0,0,0
"2012 Summer","Jordan",0,0,0,0
"2012 Summer","Saint Kitts",0,0,0,0
"2012 Summer","Ecuador",0,0,0,0
"2012 Summer","Liechtenstein",0,0,0,0
"2012 Summer","Democratic Republic of the Congo",0,0,0,0
"2012 Summer","Belize",0,0,0,0
"2012 Summer","Timor-Leste",0,0,0,0
"2012 Summer","Eritrea",0,0,0,0
"2012 Summer","Comoros",0,0,0,0
"2012 Summer","Kyrgyzstan",0,0,0,0
"2012 Summer","Nigeria",0,0,0,0
"2012 Summer","Virgin Islands, British",0,0,0,0
"2012 Summer","Peru",0,0,0,0
"2012 Summer","Kiribati",0,0,0,0
"2012 Summer","Papua New Guinea",0,0,0,0
"2012 Summer","Myanmar",0,0,0,0
"2012 Summer","Antigua",0,0,0,0
"2012 Summer","Albania",0,0,0,0
"2012 Summer","Suriname",0,0,0,0
"2012 Summer","Angola",0,0,0,0
"2012 Summer","Dominica",0,0,0,0
"2012 Summer","Uruguay",0,0,0,0
"2012 Summer","Togo",0,0,0,0
"2012 Summer","Guyana",0,0,0,0
"2012 Summer","Sierra Leone",0,0,0,0
"2012 Summer","Palestine",0,0,0,0
"2012 Summer","El Salvador",0,0,0,0
"2012 Summer","Guinea-Bissau",0,0,0,0
"2012 Summer","Pakistan",0,0,0,0
"2012 Summer","Samoa",0,0,0,0
"2012 Summer","Barbados",0,0,0,0
"2012 Summer","Mali",0,0,0,0
"2012 Summer","Equatorial Guinea",0,0,0,0
"2012 Summer","Lebanon",0,0,0,0
"2012 Summer","Palau",0,0,0,0
"2012 Summer","Republic of Congo",0,0,0,0
"2012 Summer","Rwanda",0,0,0,0
"2012 Summer","Seychelles",0,0,0,0
"2012 Summer","Guam",0,0,0,0
"2012 Summer","Marshall Islands",0,0,0,0
"2012 Summer","Macedonia",0,0,0,0
"2012 Summer","Fiji",0,0,0,0
"2012 Summer","Micronesia",0,0,0,0
"2012 Summer","Virgin Islands, US",0,0,0,0
"2012 Summer","Ivory Coast",0,0,0,0
"2012 Summer","Mauritania",0,0,0,0
"2012 Summer","Cook Islands",0,0,0,0
"2012 Summer","Oman",0,0,0,0
"2012 Summer","Vanuatu",0,0,0,0
"2012 Summer","Bhutan",0,0,0,0
"2012 Summer","Sudan",0,0,0,0
"2012 Summer","Sao Tome and Principe",0,0,0,0
"2012 Summer","Yemen",0,0,0,0
"2012 Summer","Madagascar",0,0,0,0
"2012 Summer","Israel",0,0,0,0
"2012 Summer","Cambodia",0,0,0,0
"2012 Summer","Burkina Faso",0,0,0,0
"2014 Winter","Canada",59,22,5,86
"2014 Winter","Russia",33,22,13,68
"2014 Winter","USA",10,30,24,64
"2014 Winter","Sweden",8,32,11,51
"2014 Winter","Norway",18,5,13,36
"2014 Winter","Germany",15,12,9,36
"2014 Winter","Finland",2,7,24,33
"2014 Winter","Switzerland",6,4,20,30
"2014 Winter","Netherlands",13,7,9,29
"2014 Winter","Austria",4,12,11,27
"2014 Winter","France",4,4,10,18
"2014 Winter","South Korea",7,5,2,14
"2014 Winter","Italy",0,2,12,14
"2014 Winter","China",3,4,5,12
"2014 Winter","Poland",4,4,3,11
"2014 Winter","Czech Republic",2,7,2,11
"2014 Winter","Japan",1,4,6,11
"2014 Winter","Latvia",0,5,6,11
"2014 Winter","UK",1,4,5,10
"2014 Winter","Slovenia",2,2,4,8
"2014 Winter","Belarus",5,0,1,6
"2014 Winter","Ukraine",4,0,1,5
"2014 Winter","Australia",0,2,1,3
"2014 Winter","Slovakia",1,0,0,1
"2014 Winter","Croatia",0,1,0,1
"2014 Winter","Kazakhstan",0,0,1,1
"2014 Winter","Mongolia",0,0,0,0
"2014 Winter","Azerbaijan",0,0,0,0
"2014 Winter","Georgia",0,0,0,0
"2014 Winter","Greece",0,0,0,0
"2014 Winter","Bosnia and Herzegovina",0,0,0,0
"2014 Winter","Belgium",0,0,0,0
"2014 Winter","Peru",0,0,0,0
"2014 Winter","San Marino",0,0,0,0
"2014 Winter","Uzbekistan",0,0,0,0
"2014 Winter","Morocco",0,0,0,0
"2014 Winter","Virgin Islands, British",0,0,0,0
"2014 Winter","Brazil",0,0,0,0
"2014 Winter","New Zealand",0,0,0,0
"2014 Winter","Thailand",0,0,0,0
"2014 Winter","Dominica",0,0,0,0
"2014 Winter","Armenia",0,0,0,0
"2014 Winter","Iceland",0,0,0,0
"2014 Winter","Liechtenstein",0,0,0,0
"2014 Winter","Taiwan",0,0,0,0
"2014 Winter","Bulgaria",0,0,0,0
"2014 Winter","Chile",0,0,0,0
"2014 Winter","Monaco",0,0,0,0
"2014 Winter","Hungary",0,0,0,0
"2014 Winter","Romania",0,0,0,0
"2014 Winter","Turkey",0,0,0,0
"2014 Winter","Cayman Islands",0,0,0,0
"2014 Winter","Philippines",0,0,0,0
"2014 Winter","Lebanon",0,0,0,0
"2014 Winter","Individual Olympic Athletes",0,0,0,0
"2014 Winter","Ireland",0,0,0,0
"2014 Winter","Venezuela",0,0,0,0
"2014 Winter","Jamaica",0,0,0,0
"2014 Winter","Estonia",0,0,0,0
"2014 Winter","India",0,0,0,0
"2014 Winter","Zimbabwe",0,0,0,0
"2014 Winter","Iran",0,0,0,0
"2014 Winter","Spain",0,0,0,0
"2014 Winter","Portugal",0,0,0,0
"2014 Winter","Luxembourg",0,0,0,0
"2014 Winter","Togo",0,0,0,0
"2014 Winter","Mexico",0,0,0,0
"2014 Winter","Serbia",0,0,0,0
"2014 Winter","Malta",0,0,0,0
"2014 Winter","Tonga",0,0,0,0
"2014 Winter","Albania",0,0,0,0
"2014 Winter","Israel",0,0,0,0
"2014 Winter","Timor-Leste",0,0,0,0
"2014 Winter","Andorra",0,0,0,0
"2014 Winter","Virgin Islands, US",0,0,0,0
"2014 Winter","Montenegro",0,0,0,0
"2014 Winter","Bermuda",0,0,0,0
"2014 Winter","Macedonia",0,0,0,0
"2014 Winter","Paraguay",0,0,0,0
"2014 Winter","Cyprus",0,0,0,0
"2014 Winter","Tajikistan",0,0,0,0
"2014 Winter","Pakistan",0,0,0,0
"2014 Winter","Lithuania",0,0,0,0
"2014 Winter","Argentina",0,0,0,0
"2014 Winter","Kyrgyzstan",0,0,0,0
"2014 Winter","Nepal",0,0,0,0
"2014 Winter","Denmark",0,0,0,0
"2014 Winter","Moldova",0,0,0,0
"2016 Summer","USA",139,54,71,264
"2016 Summer","Germany",49,43,67,159
"2016 Summer","UK",64,55,26,145
"2016 Summer","Russia",52,28,35,115
"2016 Summer","China",46,30,37,113
"2016 Summer","France",20,55,21,96
"2016 Summer","Australia",23,34,25,82
"2016 Summer","Italy",8,40,24,72
"2016 Summer","Canada",4,4,61,69
"2016 Summer","Japan",17,13,34,64
"2016 Summer","Serbia",14,27,13,54
"2016 Summer","Brazil",36,8,6,50
"2016 Summer","Netherlands",9,25,13,47
"2016 Summer","Spain",9,19,17,45
"2016 Summer","Denmark",15,10,16,41
"2016 Summer","New Zealand",6,25,5,36
"2016 Summer","Jamaica",11,17,2,30
"2016 Summer","Sweden",2,23,3,28
"2016 Summer","South Korea",13,3,10,26
"2016 Summer","Croatia",7,15,2,24
"2016 Summer","South Africa",2,7,14,23
"2016 Summer","Argentina",21,1,0,22
"2016 Summer","Hungary",12,3,7,22
"2016 Summer","Belgium",2,17,2,21
"2016 Summer","Norway",0,0,19,19
"2016 Summer","Kazakhstan",3,5,10,18
"2016 Summer","Azerbaijan",1,7,10,18
"2016 Summer","Nigeria",0,0,18,18
"2016 Summer","Romania",4,2,10,16
"2016 Summer","Poland",3,3,10,16
"2016 Summer","Ukraine",2,8,5,15
"2016 Summer","Czech Republic",1,2,12,15
"2016 Summer","Fiji",13,0,0,13
"2016 Summer","Kenya",6,6,1,13
"2016 Summer","Uzbekistan",4,2,7,13
"2016 Summer","Belarus",1,4,7,12
"2016 Summer","Switzerland",6,3,2,11
"2016 Summer","Cuba",5,2,4,11
"2016 Summer","Slovakia",3,5,0,8
"2016 Summer","Colombia",3,2,3,8
"2016 Summer","Iran",3,1,4,8
"2016 Summer","Turkey",1,3,4,8
"2016 Summer","Ethiopia",1,2,5,8
"2016 Summer","Malaysia",0,7,1,8
"2016 Summer","Greece",3,1,3,7
"2016 Summer","North Korea",2,3,2,7
"2016 Summer","Georgia",2,1,4,7
"2016 Summer","Lithuania",0,2,5,7
"2016 Summer","Bulgaria",0,1,6,7
"2016 Summer","Thailand",2,2,2,6
"2016 Summer","Bahamas",1,0,5,6
"2016 Summer","Taiwan",1,0,4,5
"2016 Summer","Mexico",0,3,2,5
"2016 Summer","Indonesia",2,2,0,4
"2016 Summer","Armenia",1,3,0,4
"2016 Summer","Slovenia",1,2,1,4
"2016 Summer","Estonia",0,0,4,4
"2016 Summer","Ireland",0,3,0,3
"2016 Summer","Venezuela",0,1,2,3
"2016 Summer","Tunisia",0,0,3,3
"2016 Summer","Egypt",0,0,3,3
"2016 Summer","Bahrain",1,1,0,2
"2016 Summer","Vietnam",1,1,0,2
"2016 Summer","Individual Olympic Athletes",1,0,1,2
"2016 Summer","Ivory Coast",1,0,1,2
"2016 Summer","Algeria",0,2,0,2
"2016 Summer","India",0,1,1,2
"2016 Summer","Mongolia",0,1,1,2
"2016 Summer","Austria",0,0,2,2
"2016 Summer","Israel",0,0,2,2
"2016 Summer","Tajikistan",1,0,0,1
"2016 Summer","Kosovo",1,0,0,1
"2016 Summer","Puerto Rico",1,0,0,1
"2016 Summer","Jordan",1,0,0,1
"2016 Summer","Niger",0,1,0,1
"2016 Summer","Philippines",0,1,0,1
"2016 Summer","Qatar",0,1,0,1
"2016 Summer","Burundi",0,1,0,1
"2016 Summer","Grenada",0,1,0,1
"2016 Summer","United Arab Emirates",0,0,1,1
"2016 Summer","Finland",0,0,1,1
"2016 Summer","Portugal",0,0,1,1
"2016 Summer","Morocco",0,0,1,1
"2016 Summer","Dominican Republic",0,0,1,1
"2016 Summer","Trinidad",0,0,1,1
"2016 Summer","Moldova",0,0,0,0
"2016 Summer","Mauritania",0,0,0,0
"2016 Summer","Uruguay",0,0,0,0
"2016 Summer","Luxembourg",0,0,0,0
"2016 Summer","Bhutan",0,0,0,0
"2016 Summer","Uganda",0,0,0,0
"2016 Summer","Afghanistan",0,0,0,0
"2016 Summer","Guinea",0,0,0,0
"2016 Summer","Monaco",0,0,0,0
"2016 Summer","Brunei",0,0,0,0
"2016 Summer","Saint Lucia",0,0,0,0
"2016 Summer","Virgin Islands, British",0,0,0,0
"2016 Summer","Vanuatu",0,0,0,0
"2016 Summer","Tanzania",0,0,0,0
"2016 Summer","Dominica",0,0,0,0
"2016 Summer","Myanmar",0,0,0,0
"2016 Summer","Palestine",0,0,0,0
"2016 Summer","Equatorial Guinea",0,0,0,0
"2016 Summer","Lesotho",0,0,0,0
"2016 Summer","Bangladesh",0,0,0,0
"2016 Summer","Gabon",0,0,0,0
"2016 Summer","Libya",0,0,0,0
"2016 Summer","Benin",0,0,0,0
"2016 Summer","Cape Verde",0,0,0,0
"2016 Summer","Mauritius",0,0,0,0
"2016 Summer","Sudan",0,0,0,0
"2016 Summer","Saint Kitts",0,0,0,0
"2016 Summer","Comoros",0,0,0,0
"2016 Summer","Turkmenistan",0,0,0,0
"2016 Summer","Zimbabwe",0,0,0,0
"2016 Summer","Swaziland",0,0,0,0
"2016 Summer","Cayman Islands",0,0,0,0
"2016 Summer","Montenegro",0,0,0,0
"2016 Summer","Burkina Faso",0,0,0,0
"2016 Summer","Senegal",0,0,0,0
"2016 Summer","Haiti",0,0,0,0
"2016 Summer","El Salvador",0,0,0,0
"2016 Summer","Guinea-Bissau",0,0,0,0
"2016 Summer","Malawi",0,0,0,0
"2016 Summer","American Samoa",0,0,0,0
"2016 Summer","Iraq",0,0,0,0
"2016 Summer","Mali",0,0,0,0
"2016 Summer","South Sudan",0,0,0,0
"2016 Summer","Djibouti",0,0,0,0
"2016 Summer","Ghana",0,0,0,0
"2016 Summer","Togo",0,0,0,0
"2016 Summer","Belize",0,0,0,0
"2016 Summer","Marshall Islands",0,0,0,0
"2016 Summer","Guyana",0,0,0,0
"2016 Summer","Antigua",0,0,0,0
"2016 Summer","Cyprus",0,0,0,0
"2016 Summer","Lebanon",0,0,0,0
"2016 Summer","Kiribati",0,0,0,0
"2016 Summer","Cook Islands",0,0,0,0
"2016 Summer","Guatemala",0,0,0,0
"2016 Summer","Liechtenstein",0,0,0,0
"2016 Summer","San Marino",0,0,0,0
"2016 Summer","Sri Lanka",0,0,0,0
"2016 Summer","Peru",0,0,0,0
"2016 Summer","Iceland",0,0,0,0
"2016 Summer","Albania",0,0,0,0
"2016 Summer","Micronesia",0,0,0,0
"2016 Summer","Palau",0,0,0,0
"2016 Summer","Andorra",0,0,0,0
"2016 Summer","Suriname",0,0,0,0
"2016 Summer","Eritrea",0,0,0,0
"2016 Summer","Oman",0,0,0,0
"2016 Summer","Samoa",0,0,0,0
"2016 Summer","Angola",0,0,0,0
"2016 Summer","Chad",0,0,0,0
"2016 Summer","Macedonia",0,0,0,0
"2016 Summer","Guam",0,0,0,0
"2016 Summer","Honduras",0,0,0,0
"2016 Summer","Timor-Leste",0,0,0,0
"2016 Summer","Costa Rica",0,0,0,0
"2016 Summer","Madagascar",0,0,0,0
"2016 Summer","Panama",0,0,0,0
"2016 Summer","Rwanda",0,0,0,0
"2016 Summer","Democratic Republic of the Congo",0,0,0,0
"2016 Summer","Sao Tome and Principe",0,0,0,0
"2016 Summer","Chile",0,0,0,0
"2016 Summer","Seychelles",0,0,0,0
"2016 Summer","Nepal",0,0,0,0
"2016 Summer","Somalia",0,0,0,0
"2016 Summer","Bosnia and Herzegovina",0,0,0,0
"2016 Summer","Syria",0,0,0,0
"2016 Summer","Botswana",0,0,0,0
"2016 Summer","Virgin Islands, US",0,0,0,0
"2016 Summer","Paraguay",0,0,0,0
"2016 Summer","Cameroon",0,0,0,0
"2016 Summer","Yemen",0,0,0,0
"2016 Summer","Mozambique",0,0,0,0
"2016 Summer","Pakistan",0,0,0,0
"2016 Summer","Malta",0,0,0,0
"2016 Summer","Nauru",0,0,0,0
"2016 Summer","Bermuda",0,0,0,0
"2016 Summer","Solomon Islands",0,0,0,0
"2016 Summer","Nicaragua",0,0,0,0
"2016 Summer","Namibia",0,0,0,0
"2016 Summer","Papua New Guinea",0,0,0,0
"2016 Summer","Central African Republic",0,0,0,0
"2016 Summer","Cambodia",0,0,0,0
"2016 Summer","NA",0,0,0,0
"2016 Summer","Saudi Arabia",0,0,0,0
"2016 Summer","Ecuador",0,0,0,0
"2016 Summer","Maldives",0,0,0,0
"2016 Summer","Republic of Congo",0,0,0,0
"2016 Summer","Zambia",0,0,0,0
"2016 Summer","Sierra Leone",0,0,0,0
"2016 Summer","Kyrgyzstan",0,0,0,0
"2016 Summer","Barbados",0,0,0,0
"2016 Summer","Boliva",0,0,0,0
"2016 Summer","Tonga",0,0,0,0
"2016 Summer","Saint Vincent",0,0,0,0
"2016 Summer","Latvia",0,0,0,0
"2016 Summer","Aruba",0,0,0,0
"2016 Summer","Laos",0,0,0,0
"2016 Summer","Liberia",0,0,0,0
"2016 Summer","Gambia",0,0,0,0
